month,state,permit,handgun,long_gun,other,Total Sales,Year,Month
2023-09,Alabama,10342,15421,12848,1156,29425,2023,Sep
2023-09,Alaska,188,2429,2543,262,5234,2023,Sep
2023-09,Arizona,9113,14398,8239,1575,24212,2023,Sep
2023-09,Arkansas,2139,5645,6108,437,12190,2023,Sep
2023-09,California,28611,33792,20548,4295,58635,2023,Sep
2023-09,Colorado,7012,16429,12217,1475,30121,2023,Sep
2023-09,Connecticut,6120,4723,1797,350,6870,2023,Sep
2023-09,Delaware,177,1608,1039,76,2723,2023,Sep
2023-09,District of Columbia,674,202,15,0,217,2023,Sep
2023-09,Florida,8399,51223,20945,4528,76696,2023,Sep
2023-09,Georgia,10171,14264,9395,930,24589,2023,Sep
2023-09,Guam,0,140,77,13,230,2023,Sep
2023-09,Hawaii,1685,0,0,0,0,2023,Sep
2023-09,Idaho,3325,4475,5422,451,10348,2023,Sep
2023-09,Illinois,191538,19675,10357,786,30818,2023,Sep
2023-09,Indiana,366,16104,11963,1480,29547,2023,Sep
2023-09,Iowa,3030,2027,2936,123,5086,2023,Sep
2023-09,Kansas,1572,4738,5289,627,10654,2023,Sep
2023-09,Kentucky,509,8369,7610,472,16451,2023,Sep
2023-09,Louisiana,1586,9390,10164,746,20300,2023,Sep
2023-09,Maine,317,3096,4646,303,8045,2023,Sep
2023-09,Mariana Islands,0,6,9,0,15,2023,Sep
2023-09,Maryland,8624,6291,5594,105,11990,2023,Sep
2023-09,Massachusetts,7758,4306,2586,1066,7958,2023,Sep
2023-09,Michigan,15744,16471,16313,1647,34431,2023,Sep
2023-09,Minnesota,10882,8341,14133,827,23301,2023,Sep
2023-09,Mississippi,2375,6519,6247,402,13168,2023,Sep
2023-09,Missouri,923,15275,14310,1627,31212,2023,Sep
2023-09,Montana,873,3871,5447,334,9652,2023,Sep
2023-09,Nebraska,3634,112,1625,17,1754,2023,Sep
2023-09,Nevada,2282,3967,2074,327,6368,2023,Sep
2023-09,New Hampshire,1021,4966,3106,443,8515,2023,Sep
2023-09,New Jersey,0,6157,3372,835,10364,2023,Sep
2023-09,New Mexico,1317,5733,3873,503,10109,2023,Sep
2023-09,New York,3555,10511,14257,1318,26086,2023,Sep
2023-09,North Carolina,10456,20144,11064,1167,32375,2023,Sep
2023-09,North Dakota,383,1508,3088,122,4718,2023,Sep
2023-09,Ohio,6841,18621,14068,1400,34089,2023,Sep
2023-09,Oklahoma,2833,9595,8238,1155,18988,2023,Sep
2023-09,Oregon,4884,11690,9902,1684,23276,2023,Sep
2023-09,Pennsylvania,25921,35055,19948,26,55029,2023,Sep
2023-09,Puerto Rico,0,3458,332,41,3831,2023,Sep
2023-09,Rhode Island,0,923,536,77,1536,2023,Sep
2023-09,South Carolina,8671,8332,6338,820,15490,2023,Sep
2023-09,South Dakota,776,1512,3308,117,4937,2023,Sep
2023-09,Tennessee,4569,22481,15142,1597,39220,2023,Sep
2023-09,Texas,23479,46450,35984,3761,86195,2023,Sep
2023-09,Utah,9019,3894,4299,664,8857,2023,Sep
2023-09,Vermont,0,1212,1690,96,2998,2023,Sep
2023-09,Virgin Islands,111,42,2,0,44,2023,Sep
2023-09,Virginia,376,20489,14552,3110,38151,2023,Sep
2023-09,Washington,12090,13141,8428,1011,22580,2023,Sep
2023-09,West Virginia,1794,4020,5183,252,9455,2023,Sep
2023-09,Wisconsin,11408,12987,14352,847,28186,2023,Sep
2023-09,Wyoming,504,1902,2393,167,4462,2023,Sep
2023-08,Alabama,10514,16323,12014,1243,29580,2023,Aug
2023-08,Alaska,229,2567,2677,287,5531,2023,Aug
2023-08,Arizona,12938,14352,7957,1594,23903,2023,Aug
2023-08,Arkansas,3022,5821,5335,469,11625,2023,Aug
2023-08,California,33355,32817,22053,4091,58961,2023,Aug
2023-08,Colorado,7833,16006,10591,1453,28050,2023,Aug
2023-08,Connecticut,7643,4681,1728,265,6674,2023,Aug
2023-08,Delaware,431,1558,1000,93,2651,2023,Aug
2023-08,District of Columbia,921,239,8,1,248,2023,Aug
2023-08,Florida,8781,55034,19438,5008,79480,2023,Aug
2023-08,Georgia,11824,14968,8637,999,24604,2023,Aug
2023-08,Guam,0,196,92,20,308,2023,Aug
2023-08,Hawaii,1752,0,0,0,0,2023,Aug
2023-08,Idaho,6277,4449,4600,543,9592,2023,Aug
2023-08,Illinois,206445,20241,10349,811,31401,2023,Aug
2023-08,Indiana,407,16646,10978,1549,29173,2023,Aug
2023-08,Iowa,3351,1976,2421,174,4571,2023,Aug
2023-08,Kansas,2426,5147,4824,601,10572,2023,Aug
2023-08,Kentucky,636,8475,7034,552,16061,2023,Aug
2023-08,Louisiana,2060,8956,7249,774,16979,2023,Aug
2023-08,Maine,428,3111,3538,292,6941,2023,Aug
2023-08,Mariana Islands,0,20,13,1,34,2023,Aug
2023-08,Maryland,8738,8144,4771,108,13023,2023,Aug
2023-08,Massachusetts,9228,4913,2844,1240,8997,2023,Aug
2023-08,Michigan,17157,16899,13482,1661,32042,2023,Aug
2023-08,Minnesota,11427,8375,10778,856,20009,2023,Aug
2023-08,Mississippi,1840,8406,7693,490,16589,2023,Aug
2023-08,Missouri,942,16188,13538,1729,31455,2023,Aug
2023-08,Montana,884,4109,4341,308,8758,2023,Aug
2023-08,Nebraska,3655,108,1466,15,1589,2023,Aug
2023-08,Nevada,3333,4365,2014,364,6743,2023,Aug
2023-08,New Hampshire,1511,4885,2878,441,8204,2023,Aug
2023-08,New Jersey,0,6360,3102,869,10331,2023,Aug
2023-08,New Mexico,827,5602,3547,619,9768,2023,Aug
2023-08,New York,4513,10576,11456,1003,23035,2023,Aug
2023-08,North Carolina,13410,21623,10674,1307,33604,2023,Aug
2023-08,North Dakota,450,1614,2506,144,4264,2023,Aug
2023-08,Ohio,8426,18488,12634,1424,32546,2023,Aug
2023-08,Oklahoma,3494,9803,7584,1177,18564,2023,Aug
2023-08,Oregon,5482,11431,8386,1592,21409,2023,Aug
2023-08,Pennsylvania,29383,35397,18299,28,53724,2023,Aug
2023-08,Puerto Rico,0,3826,378,45,4249,2023,Aug
2023-08,Rhode Island,0,919,599,80,1598,2023,Aug
2023-08,South Carolina,7645,8554,5515,942,15011,2023,Aug
2023-08,South Dakota,888,1633,2517,130,4280,2023,Aug
2023-08,Tennessee,8783,23835,15229,1630,40694,2023,Aug
2023-08,Texas,27901,47559,30913,3810,82282,2023,Aug
2023-08,Utah,15488,3930,3634,672,8236,2023,Aug
2023-08,Vermont,0,1189,1467,79,2735,2023,Aug
2023-08,Virgin Islands,151,35,7,0,42,2023,Aug
2023-08,Virginia,238,20538,13005,3167,36710,2023,Aug
2023-08,Washington,13118,13987,7348,987,22322,2023,Aug
2023-08,West Virginia,2278,4078,4451,273,8802,2023,Aug
2023-08,Wisconsin,12462,12464,12008,830,25302,2023,Aug
2023-08,Wyoming,607,1980,2008,177,4165,2023,Aug
2023-07,Alabama,10197,15324,9081,1285,25690,2023,Jul
2023-07,Alaska,147,2644,2149,280,5073,2023,Jul
2023-07,Arizona,9910,14812,6957,1568,23337,2023,Jul
2023-07,Arkansas,2912,5552,4050,433,10035,2023,Jul
2023-07,California,30393,30198,18567,3953,52718,2023,Jul
2023-07,Colorado,8015,15430,9647,1422,26499,2023,Jul
2023-07,Connecticut,6320,4347,1494,379,6220,2023,Jul
2023-07,Delaware,691,1740,772,83,2595,2023,Jul
2023-07,District of Columbia,739,237,9,1,247,2023,Jul
2023-07,Florida,8746,59086,18577,4796,82459,2023,Jul
2023-07,Georgia,10499,14937,6725,957,22619,2023,Jul
2023-07,Guam,0,175,89,13,277,2023,Jul
2023-07,Hawaii,1337,0,0,0,0,2023,Jul
2023-07,Idaho,8265,4265,3941,537,8743,2023,Jul
2023-07,Illinois,199545,19386,8274,767,28427,2023,Jul
2023-07,Indiana,376,16217,9321,1450,26988,2023,Jul
2023-07,Iowa,2740,2015,1978,159,4152,2023,Jul
2023-07,Kansas,1818,5207,4166,603,9976,2023,Jul
2023-07,Kentucky,617,8219,5806,577,14602,2023,Jul
2023-07,Louisiana,1761,8535,5199,763,14497,2023,Jul
2023-07,Maine,310,3053,2934,269,6256,2023,Jul
2023-07,Mariana Islands,0,21,12,0,33,2023,Jul
2023-07,Maryland,7349,7961,4451,101,12513,2023,Jul
2023-07,Massachusetts,9140,3957,2284,1367,7608,2023,Jul
2023-07,Michigan,14926,16571,11322,1652,29545,2023,Jul
2023-07,Minnesota,9727,7819,7476,922,16217,2023,Jul
2023-07,Mississippi,1775,6673,4000,407,11080,2023,Jul
2023-07,Missouri,800,15409,10686,1687,27782,2023,Jul
2023-07,Montana,807,3803,3546,320,7669,2023,Jul
2023-07,Nebraska,3435,115,1151,13,1279,2023,Jul
2023-07,Nevada,3545,4118,1815,341,6274,2023,Jul
2023-07,New Hampshire,1130,4771,2525,514,7810,2023,Jul
2023-07,New Jersey,0,6752,3117,903,10772,2023,Jul
2023-07,New Mexico,746,5751,3425,554,9730,2023,Jul
2023-07,New York,5522,8486,8163,733,17382,2023,Jul
2023-07,North Carolina,13623,21984,8739,1316,32039,2023,Jul
2023-07,North Dakota,388,1454,1971,131,3556,2023,Jul
2023-07,Ohio,8477,18760,11771,1472,32003,2023,Jul
2023-07,Oklahoma,3077,9653,6393,1099,17145,2023,Jul
2023-07,Oregon,5054,11041,7676,1462,20179,2023,Jul
2023-07,Pennsylvania,26303,33320,15865,19,49204,2023,Jul
2023-07,Puerto Rico,0,3583,314,50,3947,2023,Jul
2023-07,Rhode Island,0,869,516,86,1471,2023,Jul
2023-07,South Carolina,9198,8471,4497,1036,14004,2023,Jul
2023-07,South Dakota,821,1424,1925,123,3472,2023,Jul
2023-07,Tennessee,12047,23702,12849,1494,38045,2023,Jul
2023-07,Texas,22511,47650,23317,3888,74855,2023,Jul
2023-07,Utah,11849,3925,3474,586,7985,2023,Jul
2023-07,Vermont,0,1041,1078,90,2209,2023,Jul
2023-07,Virgin Islands,389,25,8,1,34,2023,Jul
2023-07,Virginia,310,20735,11824,3133,35692,2023,Jul
2023-07,Washington,11898,12617,6268,905,19790,2023,Jul
2023-07,West Virginia,2170,4011,3927,286,8224,2023,Jul
2023-07,Wisconsin,11508,12231,9075,860,22166,2023,Jul
2023-07,Wyoming,471,1867,1655,148,3670,2023,Jul
2023-06,Alabama,10198,16880,10167,1216,28263,2023,Jun
2023-06,Alaska,238,2961,2270,275,5506,2023,Jun
2023-06,Arizona,10944,16544,7951,1675,26170,2023,Jun
2023-06,Arkansas,4128,6035,4039,466,10540,2023,Jun
2023-06,California,28968,33746,21016,4539,59301,2023,Jun
2023-06,Colorado,8170,16583,10450,1482,28515,2023,Jun
2023-06,Connecticut,8461,5038,1912,2753,9703,2023,Jun
2023-06,Delaware,1151,2004,792,91,2887,2023,Jun
2023-06,District of Columbia,1003,271,6,0,277,2023,Jun
2023-06,Florida,11470,58766,20981,4863,84610,2023,Jun
2023-06,Georgia,10906,16292,7548,932,24772,2023,Jun
2023-06,Guam,0,155,84,5,244,2023,Jun
2023-06,Hawaii,1793,0,0,0,0,2023,Jun
2023-06,Idaho,8552,5006,4368,520,9894,2023,Jun
2023-06,Illinois,243305,19399,7913,761,28073,2023,Jun
2023-06,Indiana,374,17712,9939,1512,29163,2023,Jun
2023-06,Iowa,3162,2051,1987,138,4176,2023,Jun
2023-06,Kansas,1995,5275,3913,576,9764,2023,Jun
2023-06,Kentucky,743,9015,6134,502,15651,2023,Jun
2023-06,Louisiana,1928,9389,5236,729,15354,2023,Jun
2023-06,Maine,403,3253,3112,261,6626,2023,Jun
2023-06,Mariana Islands,0,19,10,0,29,2023,Jun
2023-06,Maryland,7787,8844,4725,110,13679,2023,Jun
2023-06,Massachusetts,7878,4408,2335,1170,7913,2023,Jun
2023-06,Michigan,16807,17696,12108,1626,31430,2023,Jun
2023-06,Minnesota,10966,8093,7179,868,16140,2023,Jun
2023-06,Mississippi,2306,7655,4253,421,12329,2023,Jun
2023-06,Missouri,706,16411,11306,1587,29304,2023,Jun
2023-06,Montana,863,3876,3735,301,7912,2023,Jun
2023-06,Nebraska,3697,131,1241,19,1391,2023,Jun
2023-06,Nevada,2073,4703,2261,357,7321,2023,Jun
2023-06,New Hampshire,1083,5031,2680,453,8164,2023,Jun
2023-06,New Jersey,0,7530,3387,863,11780,2023,Jun
2023-06,New Mexico,988,6405,3704,581,10690,2023,Jun
2023-06,New York,5227,9824,9391,905,20120,2023,Jun
2023-06,North Carolina,16139,25982,9799,1266,37047,2023,Jun
2023-06,North Dakota,534,1489,2046,118,3653,2023,Jun
2023-06,Ohio,9214,18799,11658,1258,31715,2023,Jun
2023-06,Oklahoma,3737,10384,6425,1152,17961,2023,Jun
2023-06,Oregon,5455,13917,10485,1841,26243,2023,Jun
2023-06,Pennsylvania,28640,36449,18162,12,54623,2023,Jun
2023-06,Puerto Rico,0,4567,384,67,5018,2023,Jun
2023-06,Rhode Island,0,1008,566,90,1664,2023,Jun
2023-06,South Carolina,10458,9746,5128,953,15827,2023,Jun
2023-06,South Dakota,821,1563,1988,139,3690,2023,Jun
2023-06,Tennessee,12014,24651,13369,1591,39611,2023,Jun
2023-06,Texas,28900,51381,24918,3800,80099,2023,Jun
2023-06,Utah,15031,5814,5054,797,11665,2023,Jun
2023-06,Vermont,0,1498,1405,96,2999,2023,Jun
2023-06,Virgin Islands,49,43,2,0,45,2023,Jun
2023-06,Virginia,260,21984,12563,3363,37910,2023,Jun
2023-06,Washington,12822,14134,7229,924,22287,2023,Jun
2023-06,West Virginia,2272,4369,4232,262,8863,2023,Jun
2023-06,Wisconsin,11491,13776,9343,907,24026,2023,Jun
2023-06,Wyoming,537,2039,1842,149,4030,2023,Jun
2023-05,Alabama,10733,17565,9949,1179,28693,2023,May
2023-05,Alaska,185,3115,2346,294,5755,2023,May
2023-05,Arizona,11852,16609,8057,1550,26216,2023,May
2023-05,Arkansas,2697,6456,4327,405,11188,2023,May
2023-05,California,25144,34421,21695,4841,60957,2023,May
2023-05,Colorado,9246,18190,11014,1574,30778,2023,May
2023-05,Connecticut,7292,4991,1776,1779,8546,2023,May
2023-05,Delaware,984,2470,778,87,3335,2023,May
2023-05,District of Columbia,895,355,5,0,360,2023,May
2023-05,Florida,12457,61383,21861,4709,87953,2023,May
2023-05,Georgia,13018,17312,7429,857,25598,2023,May
2023-05,Guam,0,113,64,13,190,2023,May
2023-05,Hawaii,2282,0,0,0,0,2023,May
2023-05,Idaho,7179,5047,4681,590,10318,2023,May
2023-05,Illinois,341541,23805,11014,1103,35922,2023,May
2023-05,Indiana,398,18327,10110,1464,29901,2023,May
2023-05,Iowa,3861,2236,1939,136,4311,2023,May
2023-05,Kansas,2034,5434,3993,535,9962,2023,May
2023-05,Kentucky,790,9498,6426,502,16426,2023,May
2023-05,Louisiana,2291,10189,5502,681,16372,2023,May
2023-05,Maine,482,3398,3030,273,6701,2023,May
2023-05,Mariana Islands,0,17,6,0,23,2023,May
2023-05,Maryland,8767,11070,5267,109,16446,2023,May
2023-05,Massachusetts,8918,4567,2330,1095,7992,2023,May
2023-05,Michigan,18254,18504,12622,1673,32799,2023,May
2023-05,Minnesota,15261,9207,8339,913,18459,2023,May
2023-05,Mississippi,2849,7790,4296,375,12461,2023,May
2023-05,Missouri,797,17012,11619,1610,30241,2023,May
2023-05,Montana,973,4235,4011,314,8560,2023,May
2023-05,Nebraska,4949,158,1205,19,1382,2023,May
2023-05,Nevada,3576,4890,2324,352,7566,2023,May
2023-05,New Hampshire,1122,5556,2861,388,8805,2023,May
2023-05,New Jersey,0,8319,3667,1021,13007,2023,May
2023-05,New Mexico,1357,6492,3980,574,11046,2023,May
2023-05,New York,5867,10007,9564,1007,20578,2023,May
2023-05,North Carolina,18244,30437,10045,1315,41797,2023,May
2023-05,North Dakota,784,1602,2142,125,3869,2023,May
2023-05,Ohio,9365,20161,11643,1319,33123,2023,May
2023-05,Oklahoma,3347,11097,7021,1109,19227,2023,May
2023-05,Oregon,5986,19095,15002,2558,36655,2023,May
2023-05,Pennsylvania,31735,37238,17503,23,54764,2023,May
2023-05,Puerto Rico,0,4803,373,44,5220,2023,May
2023-05,Rhode Island,0,976,610,117,1703,2023,May
2023-05,South Carolina,9849,10051,5112,856,16019,2023,May
2023-05,South Dakota,887,1683,2009,143,3835,2023,May
2023-05,Tennessee,13188,25911,13591,1592,41094,2023,May
2023-05,Texas,23734,58444,27280,3780,89504,2023,May
2023-05,Utah,18502,4930,4030,731,9691,2023,May
2023-05,Vermont,0,1429,1407,85,2921,2023,May
2023-05,Virgin Islands,74,37,2,1,40,2023,May
2023-05,Virginia,289,22469,12389,3212,38070,2023,May
2023-05,Washington,16877,16683,8441,1011,26135,2023,May
2023-05,West Virginia,2500,4709,4671,243,9623,2023,May
2023-05,Wisconsin,11254,15866,10353,877,27096,2023,May
2023-05,Wyoming,546,2165,2024,165,4354,2023,May
2023-04,Alabama,9948,18898,11836,1172,31906,2023,Apr
2023-04,Alaska,217,3390,2743,327,6460,2023,Apr
2023-04,Arizona,11311,18141,9179,1603,28923,2023,Apr
2023-04,Arkansas,3076,6947,5295,427,12669,2023,Apr
2023-04,California,24760,35813,23385,5158,64356,2023,Apr
2023-04,Colorado,9217,20159,13616,2038,35813,2023,Apr
2023-04,Connecticut,7428,5971,1919,1023,8913,2023,Apr
2023-04,Delaware,1113,2270,899,99,3268,2023,Apr
2023-04,District of Columbia,846,394,9,1,404,2023,Apr
2023-04,Florida,15760,69152,24519,4616,98287,2023,Apr
2023-04,Georgia,12933,18162,8498,882,27542,2023,Apr
2023-04,Guam,0,142,80,16,238,2023,Apr
2023-04,Hawaii,1912,0,0,0,0,2023,Apr
2023-04,Idaho,11989,5796,5703,619,12118,2023,Apr
2023-04,Illinois,397601,27184,11406,1364,39954,2023,Apr
2023-04,Indiana,412,20732,12656,1670,35058,2023,Apr
2023-04,Iowa,4984,2867,2720,161,5748,2023,Apr
2023-04,Kansas,1898,6260,4871,622,11753,2023,Apr
2023-04,Kentucky,735,10210,8238,646,19094,2023,Apr
2023-04,Louisiana,6444,10749,5961,800,17510,2023,Apr
2023-04,Maine,530,3975,3884,332,8191,2023,Apr
2023-04,Mariana Islands,0,19,7,0,26,2023,Apr
2023-04,Maryland,11002,10756,5927,128,16811,2023,Apr
2023-04,Massachusetts,9026,5099,2854,1415,9368,2023,Apr
2023-04,Michigan,17952,22895,17266,2059,42220,2023,Apr
2023-04,Minnesota,16661,12619,13620,1143,27382,2023,Apr
2023-04,Mississippi,2848,8473,5084,374,13931,2023,Apr
2023-04,Missouri,808,17821,13932,1600,33353,2023,Apr
2023-04,Montana,1206,4677,4987,371,10035,2023,Apr
2023-04,Nebraska,4929,174,1592,22,1788,2023,Apr
2023-04,Nevada,4123,5193,2525,369,8087,2023,Apr
2023-04,New Hampshire,1206,6140,3556,455,10151,2023,Apr
2023-04,New Jersey,0,8404,3677,982,13063,2023,Apr
2023-04,New Mexico,779,6711,4144,569,11424,2023,Apr
2023-04,New York,5224,11156,12438,1366,24960,2023,Apr
2023-04,North Carolina,18825,46040,11984,1388,59412,2023,Apr
2023-04,North Dakota,575,2115,3021,163,5299,2023,Apr
2023-04,Ohio,9427,23293,15181,1549,40023,2023,Apr
2023-04,Oklahoma,3207,12767,8668,1360,22795,2023,Apr
2023-04,Oregon,6361,26529,16392,301,43222,2023,Apr
2023-04,Pennsylvania,31299,43869,21576,47,65492,2023,Apr
2023-04,Puerto Rico,0,4396,382,40,4818,2023,Apr
2023-04,Rhode Island,0,1176,736,148,2060,2023,Apr
2023-04,South Carolina,6034,10395,5517,737,16649,2023,Apr
2023-04,South Dakota,980,2093,2740,191,5024,2023,Apr
2023-04,Tennessee,16198,27862,16636,1935,46433,2023,Apr
2023-04,Texas,25622,56795,28584,4022,89401,2023,Apr
2023-04,Utah,15136,5118,4380,757,10255,2023,Apr
2023-04,Vermont,0,1708,1881,105,3694,2023,Apr
2023-04,Virgin Islands,27,20,5,0,25,2023,Apr
2023-04,Virginia,427,25421,15125,3368,43914,2023,Apr
2023-04,Washington,15817,23767,19992,24063,67822,2023,Apr
2023-04,West Virginia,2690,4945,5480,272,10697,2023,Apr
2023-04,Wisconsin,14239,19668,15193,1093,35954,2023,Apr
2023-04,Wyoming,519,2275,2214,193,4682,2023,Apr
2023-03,Alabama,14315,23132,15158,1314,39604,2023,Mar
2023-03,Alaska,354,3295,2610,397,6302,2023,Mar
2023-03,Arizona,12965,20940,10397,1772,33109,2023,Mar
2023-03,Arkansas,4460,8827,6436,573,15836,2023,Mar
2023-03,California,25878,40714,26473,5455,72642,2023,Mar
2023-03,Colorado,11466,24432,15658,2504,42594,2023,Mar
2023-03,Connecticut,9850,7098,2405,1076,10579,2023,Mar
2023-03,Delaware,533,2596,1160,94,3850,2023,Mar
2023-03,District of Columbia,1101,412,20,1,433,2023,Mar
2023-03,Florida,22358,65213,25801,4828,95842,2023,Mar
2023-03,Georgia,16978,22752,10535,1068,34355,2023,Mar
2023-03,Guam,0,133,107,21,261,2023,Mar
2023-03,Hawaii,2307,0,0,0,0,2023,Mar
2023-03,Idaho,7853,6539,5830,724,13093,2023,Mar
2023-03,Illinois,449383,34238,14033,1661,49932,2023,Mar
2023-03,Indiana,462,26541,14706,2078,43325,2023,Mar
2023-03,Iowa,7412,3578,3699,227,7504,2023,Mar
2023-03,Kansas,777,7705,6440,790,14935,2023,Mar
2023-03,Kentucky,859,12713,9877,725,23315,2023,Mar
2023-03,Louisiana,2514,13598,7006,816,21420,2023,Mar
2023-03,Maine,646,4753,4071,407,9231,2023,Mar
2023-03,Mariana Islands,0,6,8,0,14,2023,Mar
2023-03,Maryland,16265,13403,6825,159,20387,2023,Mar
2023-03,Massachusetts,9986,6309,3486,1651,11446,2023,Mar
2023-03,Michigan,22414,29457,20434,2576,52467,2023,Mar
2023-03,Minnesota,18971,13594,13285,1195,28074,2023,Mar
2023-03,Mississippi,3091,10954,6779,495,18228,2023,Mar
2023-03,Missouri,1082,23855,17769,2084,43708,2023,Mar
2023-03,Montana,1252,5511,4888,438,10837,2023,Mar
2023-03,Nebraska,6284,232,1899,28,2159,2023,Mar
2023-03,Nevada,3169,6250,2791,450,9491,2023,Mar
2023-03,New Hampshire,1247,6838,3567,493,10898,2023,Mar
2023-03,New Jersey,0,10810,4653,1098,16561,2023,Mar
2023-03,New Mexico,889,8550,4994,646,14190,2023,Mar
2023-03,New York,6278,13030,13570,1592,28192,2023,Mar
2023-03,North Carolina,37018,10041,13772,1214,25027,2023,Mar
2023-03,North Dakota,512,2456,3123,188,5767,2023,Mar
2023-03,Ohio,10943,29772,17706,2057,49535,2023,Mar
2023-03,Oklahoma,3544,14152,9540,1456,25148,2023,Mar
2023-03,Oregon,7312,32266,17703,0,49969,2023,Mar
2023-03,Pennsylvania,41187,54232,25246,31,79509,2023,Mar
2023-03,Puerto Rico,0,4768,382,60,5210,2023,Mar
2023-03,Rhode Island,0,1299,793,133,2225,2023,Mar
2023-03,South Carolina,8300,13880,6899,871,21650,2023,Mar
2023-03,South Dakota,1089,2611,3330,201,6142,2023,Mar
2023-03,Tennessee,18633,32348,18569,2001,52918,2023,Mar
2023-03,Texas,32277,67368,32194,4370,103932,2023,Mar
2023-03,Utah,18689,6476,5263,835,12574,2023,Mar
2023-03,Vermont,0,2172,1958,153,4283,2023,Mar
2023-03,Virgin Islands,133,43,6,0,49,2023,Mar
2023-03,Virginia,424,28577,16656,3867,49100,2023,Mar
2023-03,Washington,17537,26460,22044,26896,75400,2023,Mar
2023-03,West Virginia,3686,6697,6782,386,13865,2023,Mar
2023-03,Wisconsin,17148,23317,17653,1293,42263,2023,Mar
2023-03,Wyoming,551,2705,2411,230,5346,2023,Mar
2023-02,Alabama,10966,22128,13370,1209,36707,2023,Feb
2023-02,Alaska,167,2607,2025,312,4944,2023,Feb
2023-02,Arizona,8930,18576,8692,1538,28806,2023,Feb
2023-02,Arkansas,1981,7850,6003,469,14322,2023,Feb
2023-02,California,21763,36098,21837,4641,62576,2023,Feb
2023-02,Colorado,8940,19318,11729,1886,32933,2023,Feb
2023-02,Connecticut,8538,5941,1937,997,8875,2023,Feb
2023-02,Delaware,615,2325,1005,90,3420,2023,Feb
2023-02,District of Columbia,885,307,16,2,325,2023,Feb
2023-02,Florida,19584,60511,22852,4587,87950,2023,Feb
2023-02,Georgia,15422,21324,9576,1028,31928,2023,Feb
2023-02,Guam,0,148,69,12,229,2023,Feb
2023-02,Hawaii,1722,0,0,0,0,2023,Feb
2023-02,Idaho,7686,5631,4694,621,10946,2023,Feb
2023-02,Illinois,372638,27357,10907,1103,39367,2023,Feb
2023-02,Indiana,347,24114,12607,1765,38486,2023,Feb
2023-02,Iowa,5950,3022,2825,199,6046,2023,Feb
2023-02,Kansas,839,7396,5821,732,13949,2023,Feb
2023-02,Kentucky,690,12761,8864,662,22287,2023,Feb
2023-02,Louisiana,1674,12585,6683,756,20024,2023,Feb
2023-02,Maine,522,4018,3366,321,7705,2023,Feb
2023-02,Mariana Islands,0,15,5,0,20,2023,Feb
2023-02,Maryland,13140,12686,5806,138,18630,2023,Feb
2023-02,Massachusetts,8895,5596,2764,1417,9777,2023,Feb
2023-02,Michigan,17577,24124,15758,2175,42057,2023,Feb
2023-02,Minnesota,12512,10910,9693,1033,21636,2023,Feb
2023-02,Mississippi,2972,10674,6743,481,17898,2023,Feb
2023-02,Missouri,758,21445,15486,1910,38841,2023,Feb
2023-02,Montana,920,4166,3859,330,8355,2023,Feb
2023-02,Nebraska,4840,223,1771,33,2027,2023,Feb
2023-02,Nevada,2537,5046,2174,362,7582,2023,Feb
2023-02,New Hampshire,989,6241,3109,437,9787,2023,Feb
2023-02,New Jersey,0,8541,3731,936,13208,2023,Feb
2023-02,New Mexico,661,7439,4251,645,12335,2023,Feb
2023-02,New York,5128,10597,10952,1292,22841,2023,Feb
2023-02,North Carolina,33159,1745,12607,1103,15455,2023,Feb
2023-02,North Dakota,609,2174,2472,153,4799,2023,Feb
2023-02,Ohio,8115,28191,15172,1813,45176,2023,Feb
2023-02,Oklahoma,2338,13503,9022,1488,24013,2023,Feb
2023-02,Oregon,6262,24857,12697,0,37554,2023,Feb
2023-02,Pennsylvania,35314,47212,21088,35,68335,2023,Feb
2023-02,Puerto Rico,0,4019,320,47,4386,2023,Feb
2023-02,Rhode Island,0,1164,807,184,2155,2023,Feb
2023-02,South Carolina,7041,13628,6499,770,20897,2023,Feb
2023-02,South Dakota,726,2299,2590,177,5066,2023,Feb
2023-02,Tennessee,17084,31754,16829,1961,50544,2023,Feb
2023-02,Texas,26191,63700,29634,4277,97611,2023,Feb
2023-02,Utah,11362,5255,4086,658,9999,2023,Feb
2023-02,Vermont,0,1861,1822,109,3792,2023,Feb
2023-02,Virgin Islands,82,78,4,0,82,2023,Feb
2023-02,Virginia,327,27299,15238,3617,46154,2023,Feb
2023-02,Washington,16464,17983,12653,7015,37651,2023,Feb
2023-02,West Virginia,2831,6187,5669,319,12175,2023,Feb
2023-02,Wisconsin,17120,19720,12896,1100,33716,2023,Feb
2023-02,Wyoming,435,2103,1861,163,4127,2023,Feb
2023-01,Alabama,13130,20028,13674,1403,35105,2023,Jan
2023-01,Alaska,269,2406,1779,323,4508,2023,Jan
2023-01,Arizona,8875,17744,8275,1763,27782,2023,Jan
2023-01,Arkansas,1944,6484,6290,485,13259,2023,Jan
2023-01,California,21900,35181,21735,4949,61865,2023,Jan
2023-01,Colorado,7464,18373,11230,2031,31634,2023,Jan
2023-01,Connecticut,8334,5842,1922,2514,10278,2023,Jan
2023-01,Delaware,434,2231,1081,86,3398,2023,Jan
2023-01,District of Columbia,960,326,13,0,339,2023,Jan
2023-01,Florida,19460,58648,22950,4883,86481,2023,Jan
2023-01,Georgia,16453,18081,9451,997,28529,2023,Jan
2023-01,Guam,0,188,79,19,286,2023,Jan
2023-01,Hawaii,1847,0,0,0,0,2023,Jan
2023-01,Idaho,6159,5234,4415,649,10298,2023,Jan
2023-01,Illinois,480752,28370,14140,1715,44225,2023,Jan
2023-01,Indiana,372,22825,12560,1912,37297,2023,Jan
2023-01,Iowa,6740,2527,2790,193,5510,2023,Jan
2023-01,Kansas,1315,6507,5577,708,12792,2023,Jan
2023-01,Kentucky,716,10744,8081,628,19453,2023,Jan
2023-01,Louisiana,1879,10755,7949,870,19574,2023,Jan
2023-01,Maine,522,3614,3093,352,7059,2023,Jan
2023-01,Mariana Islands,0,8,1,1,10,2023,Jan
2023-01,Maryland,21495,12299,5849,116,18264,2023,Jan
2023-01,Massachusetts,10720,5626,2799,1506,9931,2023,Jan
2023-01,Michigan,18535,21880,15056,2420,39356,2023,Jan
2023-01,Minnesota,11361,9530,8082,1016,18628,2023,Jan
2023-01,Mississippi,3346,8153,6557,511,15221,2023,Jan
2023-01,Missouri,853,19831,14724,2133,36688,2023,Jan
2023-01,Montana,996,3600,3179,388,7167,2023,Jan
2023-01,Nebraska,4240,227,1665,31,1923,2023,Jan
2023-01,Nevada,1265,4875,2288,386,7549,2023,Jan
2023-01,New Hampshire,782,6094,2872,472,9438,2023,Jan
2023-01,New Jersey,0,10554,4848,1203,16605,2023,Jan
2023-01,New Mexico,1193,6587,3912,640,11139,2023,Jan
2023-01,New York,4637,10288,10775,1211,22274,2023,Jan
2023-01,North Carolina,35510,1728,12327,1099,15154,2023,Jan
2023-01,North Dakota,514,1876,2325,172,4373,2023,Jan
2023-01,Ohio,7097,24938,13130,1563,39631,2023,Jan
2023-01,Oklahoma,2682,11935,8559,1339,21833,2023,Jan
2023-01,Oregon,7571,32268,15723,0,47991,2023,Jan
2023-01,Pennsylvania,38338,42802,19236,33,62071,2023,Jan
2023-01,Puerto Rico,0,3827,277,62,4166,2023,Jan
2023-01,Rhode Island,0,1190,622,102,1914,2023,Jan
2023-01,South Carolina,10758,10668,6069,881,17618,2023,Jan
2023-01,South Dakota,843,2015,2506,183,4704,2023,Jan
2023-01,Tennessee,19015,28782,16472,1901,47155,2023,Jan
2023-01,Texas,28661,55982,29702,4323,90007,2023,Jan
2023-01,Utah,11592,4757,3717,733,9207,2023,Jan
2023-01,Vermont,0,1575,1412,141,3128,2023,Jan
2023-01,Virgin Islands,317,25,5,0,30,2023,Jan
2023-01,Virginia,478,26233,15043,3637,44913,2023,Jan
2023-01,Washington,17327,19251,11776,5937,36964,2023,Jan
2023-01,West Virginia,2751,5280,5333,363,10976,2023,Jan
2023-01,Wisconsin,22470,16431,10812,1180,28423,2023,Jan
2023-01,Wyoming,325,1909,1571,164,3644,2023,Jan
2022-12,Alabama,16023,29645,25911,1740,57296,2022,Dec
2022-12,Alaska,196,3231,2824,372,6427,2022,Dec
2022-12,Arizona,8802,23595,11885,2120,37600,2022,Dec
2022-12,Arkansas,2461,10515,11968,624,23107,2022,Dec
2022-12,California,22839,40213,28073,5523,73809,2022,Dec
2022-12,Colorado,6354,22830,15437,1959,40226,2022,Dec
2022-12,Connecticut,5986,6526,2183,1148,9857,2022,Dec
2022-12,Delaware,274,2607,1716,115,4438,2022,Dec
2022-12,District of Columbia,945,300,21,1,322,2022,Dec
2022-12,Florida,18857,74886,35416,5826,116128,2022,Dec
2022-12,Georgia,14454,28194,19068,1341,48603,2022,Dec
2022-12,Guam,0,179,86,15,280,2022,Dec
2022-12,Hawaii,1559,0,0,0,0,2022,Dec
2022-12,Idaho,3673,8694,7551,817,17062,2022,Dec
2022-12,Illinois,426000,30563,18733,2005,51301,2022,Dec
2022-12,Indiana,330,28936,18301,2244,49481,2022,Dec
2022-12,Iowa,5396,3430,4684,250,8364,2022,Dec
2022-12,Kansas,1111,8716,8791,793,18300,2022,Dec
2022-12,Kentucky,522,16789,15697,861,33347,2022,Dec
2022-12,Louisiana,1356,17019,16403,1052,34474,2022,Dec
2022-12,Maine,448,4895,5150,419,10464,2022,Dec
2022-12,Mariana Islands,0,17,6,0,23,2022,Dec
2022-12,Maryland,22199,12642,8061,158,20861,2022,Dec
2022-12,Massachusetts,7576,6139,3159,1548,10846,2022,Dec
2022-12,Michigan,15471,25042,21169,2797,49008,2022,Dec
2022-12,Minnesota,10720,11270,11604,1221,24095,2022,Dec
2022-12,Mississippi,2903,13752,15187,634,29573,2022,Dec
2022-12,Missouri,637,27213,23525,2645,53383,2022,Dec
2022-12,Montana,886,5469,5386,463,11318,2022,Dec
2022-12,Nebraska,4475,337,2864,44,3245,2022,Dec
2022-12,Nevada,3626,6127,3153,459,9739,2022,Dec
2022-12,New Hampshire,759,7873,4217,455,12545,2022,Dec
2022-12,New Jersey,0,8341,4542,981,13864,2022,Dec
2022-12,New Mexico,1522,8527,5440,720,14687,2022,Dec
2022-12,New York,3930,10323,15319,1291,26933,2022,Dec
2022-12,North Carolina,28256,2841,23239,1438,27518,2022,Dec
2022-12,North Dakota,566,1991,2808,202,5001,2022,Dec
2022-12,Ohio,5951,33116,21775,1912,56803,2022,Dec
2022-12,Oklahoma,1910,18067,16175,1726,35968,2022,Dec
2022-12,Oregon,7031,46735,22029,0,68764,2022,Dec
2022-12,Pennsylvania,32940,53009,28275,29,81313,2022,Dec
2022-12,Puerto Rico,0,5083,357,51,5491,2022,Dec
2022-12,Rhode Island,0,1378,746,111,2235,2022,Dec
2022-12,South Carolina,14211,16374,11987,1266,29627,2022,Dec
2022-12,South Dakota,668,2608,3888,221,6717,2022,Dec
2022-12,Tennessee,13694,40500,28530,2569,71599,2022,Dec
2022-12,Texas,25237,83157,52862,5546,141565,2022,Dec
2022-12,Utah,14162,8160,7997,829,16986,2022,Dec
2022-12,Vermont,0,1994,2111,149,4254,2022,Dec
2022-12,Virgin Islands,94,25,3,0,28,2022,Dec
2022-12,Virginia,332,32824,22955,4519,60298,2022,Dec
2022-12,Washington,14608,20960,14335,4573,39868,2022,Dec
2022-12,West Virginia,1774,8317,9749,444,18510,2022,Dec
2022-12,Wisconsin,18453,19645,15194,1433,36272,2022,Dec
2022-12,Wyoming,308,3096,2932,258,6286,2022,Dec
2022-11,Alabama,15442,22068,19922,1190,43180,2022,Nov
2022-11,Alaska,292,3182,2890,332,6404,2022,Nov
2022-11,Arizona,8007,18816,9664,1513,29993,2022,Nov
2022-11,Arkansas,2325,7994,10304,439,18737,2022,Nov
2022-11,California,24117,37386,25634,4888,67908,2022,Nov
2022-11,Colorado,6598,20088,13493,1551,35132,2022,Nov
2022-11,Connecticut,6441,5660,2132,1120,8912,2022,Nov
2022-11,Delaware,257,1961,1570,76,3607,2022,Nov
2022-11,District of Columbia,1440,455,26,2,483,2022,Nov
2022-11,Florida,16592,61475,28064,4766,94305,2022,Nov
2022-11,Georgia,13585,20201,14036,866,35103,2022,Nov
2022-11,Guam,0,196,83,13,292,2022,Nov
2022-11,Hawaii,1418,0,0,0,0,2022,Nov
2022-11,Idaho,5323,6776,6569,598,13943,2022,Nov
2022-11,Illinois,412201,24875,14612,1564,41051,2022,Nov
2022-11,Indiana,315,23698,18044,1642,43384,2022,Nov
2022-11,Iowa,4379,3589,5081,176,8846,2022,Nov
2022-11,Kansas,1105,7501,7768,581,15850,2022,Nov
2022-11,Kentucky,551,12229,13521,606,26356,2022,Nov
2022-11,Louisiana,1488,12512,12952,758,26222,2022,Nov
2022-11,Maine,393,3761,4894,306,8961,2022,Nov
2022-11,Mariana Islands,0,12,8,1,21,2022,Nov
2022-11,Maryland,19965,12154,7431,121,19706,2022,Nov
2022-11,Massachusetts,9344,5791,3340,1389,10520,2022,Nov
2022-11,Michigan,15295,22446,23562,1754,47762,2022,Nov
2022-11,Minnesota,11861,11045,13156,956,25157,2022,Nov
2022-11,Mississippi,2455,9829,11939,416,22184,2022,Nov
2022-11,Missouri,702,21737,21503,1800,45040,2022,Nov
2022-11,Montana,801,4283,5028,311,9622,2022,Nov
2022-11,Nebraska,3957,263,2702,25,2990,2022,Nov
2022-11,Nevada,2283,5324,2480,363,8167,2022,Nov
2022-11,New Hampshire,723,6358,3753,323,10434,2022,Nov
2022-11,New Jersey,0,8346,3945,924,13215,2022,Nov
2022-11,New Mexico,1320,6926,4658,538,12122,2022,Nov
2022-11,New York,5462,9328,14518,1093,24939,2022,Nov
2022-11,North Carolina,26689,2400,17849,1015,21264,2022,Nov
2022-11,North Dakota,447,1914,3095,131,5140,2022,Nov
2022-11,Ohio,5430,28175,23760,1472,53407,2022,Nov
2022-11,Oklahoma,1950,14698,13433,1244,29375,2022,Nov
2022-11,Oregon,5197,57990,27862,0,85852,2022,Nov
2022-11,Pennsylvania,32362,45307,27505,28,72840,2022,Nov
2022-11,Puerto Rico,0,5943,438,64,6445,2022,Nov
2022-11,Rhode Island,0,1238,729,117,2084,2022,Nov
2022-11,South Carolina,11615,12634,9269,772,22675,2022,Nov
2022-11,South Dakota,866,2622,4447,180,7249,2022,Nov
2022-11,Tennessee,16960,31059,23116,2180,56355,2022,Nov
2022-11,Texas,24862,63821,41578,3964,109363,2022,Nov
2022-11,Utah,10217,6654,6741,676,14071,2022,Nov
2022-11,Vermont,0,1575,1910,115,3600,2022,Nov
2022-11,Virgin Islands,65,38,3,0,41,2022,Nov
2022-11,Virginia,534,27137,19880,3505,50522,2022,Nov
2022-11,Washington,14339,15840,11947,3208,30995,2022,Nov
2022-11,West Virginia,1961,6065,9079,337,15481,2022,Nov
2022-11,Wisconsin,19868,19780,17496,1038,38314,2022,Nov
2022-11,Wyoming,294,2724,2534,189,5447,2022,Nov
2022-10,Alabama,17148,17564,13145,1096,31805,2022,Oct
2022-10,Alaska,283,3319,3316,378,7013,2022,Oct
2022-10,Arizona,7855,16648,8317,1497,26462,2022,Oct
2022-10,Arkansas,2472,6579,7145,411,14135,2022,Oct
2022-10,California,27623,36991,22350,4451,63792,2022,Oct
2022-10,Colorado,6631,18115,12580,1582,32277,2022,Oct
2022-10,Connecticut,7119,5379,1875,902,8156,2022,Oct
2022-10,Delaware,407,1956,1127,86,3169,2022,Oct
2022-10,District of Columbia,1094,406,29,0,435,2022,Oct
2022-10,Florida,18365,56101,21525,4409,82035,2022,Oct
2022-10,Georgia,13137,18113,10887,822,29822,2022,Oct
2022-10,Guam,0,194,69,21,284,2022,Oct
2022-10,Hawaii,1619,0,0,0,0,2022,Oct
2022-10,Idaho,6092,5281,5944,569,11794,2022,Oct
2022-10,Illinois,369511,21387,10840,1091,33318,2022,Oct
2022-10,Indiana,270,20226,12643,1434,34303,2022,Oct
2022-10,Iowa,3746,2474,3402,129,6005,2022,Oct
2022-10,Kansas,768,5686,5589,522,11797,2022,Oct
2022-10,Kentucky,606,9836,9489,517,19842,2022,Oct
2022-10,Louisiana,1686,11485,10058,681,22224,2022,Oct
2022-10,Maine,551,3706,6019,264,9989,2022,Oct
2022-10,Mariana Islands,0,15,15,3,33,2022,Oct
2022-10,Maryland,17861,11676,6156,137,17969,2022,Oct
2022-10,Massachusetts,9156,4996,2861,1332,9189,2022,Oct
2022-10,Michigan,16796,18736,18051,1541,38328,2022,Oct
2022-10,Minnesota,12424,10012,16617,912,27541,2022,Oct
2022-10,Mississippi,2439,8304,7218,383,15905,2022,Oct
2022-10,Missouri,775,18211,17451,1639,37301,2022,Oct
2022-10,Montana,1010,3780,5862,296,9938,2022,Oct
2022-10,Nebraska,3469,106,2049,17,2172,2022,Oct
2022-10,Nevada,1637,4829,2190,334,7353,2022,Oct
2022-10,New Hampshire,953,5366,3893,348,9607,2022,Oct
2022-10,New Jersey,0,10050,4137,1067,15254,2022,Oct
2022-10,New Mexico,998,6417,4088,538,11043,2022,Oct
2022-10,New York,4513,9619,13412,943,23974,2022,Oct
2022-10,North Carolina,24964,1458,14220,982,16660,2022,Oct
2022-10,North Dakota,668,1875,4315,130,6320,2022,Oct
2022-10,Ohio,5432,21257,15147,1196,37600,2022,Oct
2022-10,Oklahoma,2166,11019,9238,969,21226,2022,Oct
2022-10,Oregon,5007,18201,11038,0,29239,2022,Oct
2022-10,Pennsylvania,34029,43318,22321,42,65681,2022,Oct
2022-10,Puerto Rico,0,4724,308,57,5089,2022,Oct
2022-10,Rhode Island,0,1011,707,104,1822,2022,Oct
2022-10,South Carolina,12315,10030,6942,695,17667,2022,Oct
2022-10,South Dakota,940,2022,5141,136,7299,2022,Oct
2022-10,Tennessee,18334,26867,17176,1776,45819,2022,Oct
2022-10,Texas,26520,56594,33532,3676,93802,2022,Oct
2022-10,Utah,10839,4412,4498,596,9506,2022,Oct
2022-10,Vermont,0,1564,2005,108,3677,2022,Oct
2022-10,Virgin Islands,56,30,5,0,35,2022,Oct
2022-10,Virginia,515,24372,16631,3310,44313,2022,Oct
2022-10,Washington,14561,15021,11570,3042,29633,2022,Oct
2022-10,West Virginia,1890,4981,6824,241,12046,2022,Oct
2022-10,Wisconsin,20063,16814,16646,955,34415,2022,Oct
2022-10,Wyoming,367,2007,2234,156,4397,2022,Oct
2022-09,Alabama,18236,17226,13518,1213,31957,2022,Sep
2022-09,Alaska,264,3738,3767,400,7905,2022,Sep
2022-09,Arizona,7643,17476,9048,1694,28218,2022,Sep
2022-09,Arkansas,2548,6670,6102,394,13166,2022,Sep
2022-09,California,39113,34417,22375,4527,61319,2022,Sep
2022-09,Colorado,6664,18944,12605,1649,33198,2022,Sep
2022-09,Connecticut,7888,5121,1660,856,7637,2022,Sep
2022-09,Delaware,537,1803,964,66,2833,2022,Sep
2022-09,District of Columbia,569,634,36,0,670,2022,Sep
2022-09,Florida,21987,52674,20389,4536,77599,2022,Sep
2022-09,Georgia,13507,17848,9552,804,28204,2022,Sep
2022-09,Guam,0,239,91,17,347,2022,Sep
2022-09,Hawaii,1570,0,0,0,0,2022,Sep
2022-09,Idaho,4495,5503,5756,566,11825,2022,Sep
2022-09,Illinois,337476,21772,10505,1175,33452,2022,Sep
2022-09,Indiana,373,21991,12729,1559,36279,2022,Sep
2022-09,Iowa,3323,2374,3089,138,5601,2022,Sep
2022-09,Kansas,998,5656,5144,550,11350,2022,Sep
2022-09,Kentucky,638,9610,7857,527,17994,2022,Sep
2022-09,Louisiana,1856,12116,9347,837,22300,2022,Sep
2022-09,Maine,529,3837,5180,291,9308,2022,Sep
2022-09,Mariana Islands,0,16,15,2,33,2022,Sep
2022-09,Maryland,17878,11129,5779,121,17029,2022,Sep
2022-09,Massachusetts,8624,4784,2739,1102,8625,2022,Sep
2022-09,Michigan,16258,19068,17606,1731,38405,2022,Sep
2022-09,Minnesota,11569,10312,14751,981,26044,2022,Sep
2022-09,Mississippi,2590,8678,6655,405,15738,2022,Sep
2022-09,Missouri,829,18416,15044,1658,35118,2022,Sep
2022-09,Montana,940,4223,5236,328,9787,2022,Sep
2022-09,Nebraska,3154,115,1758,28,1901,2022,Sep
2022-09,Nevada,1898,5043,2322,388,7753,2022,Sep
2022-09,New Hampshire,1127,5444,3616,319,9379,2022,Sep
2022-09,New Jersey,0,9214,3590,976,13780,2022,Sep
2022-09,New Mexico,1439,6341,4228,605,11174,2022,Sep
2022-09,New York,4206,10159,16180,2128,28467,2022,Sep
2022-09,North Carolina,24094,1347,12819,1094,15260,2022,Sep
2022-09,North Dakota,581,1772,3318,175,5265,2022,Sep
2022-09,Ohio,5234,22226,14018,1282,37526,2022,Sep
2022-09,Oklahoma,2205,11002,8904,1177,21083,2022,Sep
2022-09,Oregon,5005,15511,9892,0,25403,2022,Sep
2022-09,Pennsylvania,33152,40911,20583,38,61532,2022,Sep
2022-09,Puerto Rico,0,3537,263,55,3855,2022,Sep
2022-09,Rhode Island,0,1025,607,90,1722,2022,Sep
2022-09,South Carolina,14991,9923,6477,720,17120,2022,Sep
2022-09,South Dakota,1001,2118,3486,163,5767,2022,Sep
2022-09,Tennessee,16826,28479,16418,1903,46800,2022,Sep
2022-09,Texas,28270,54688,36257,4023,94968,2022,Sep
2022-09,Utah,10707,4710,4497,568,9775,2022,Sep
2022-09,Vermont,0,1629,1887,121,3637,2022,Sep
2022-09,Virgin Islands,91,38,2,0,40,2022,Sep
2022-09,Virginia,444,23514,14899,3420,41833,2022,Sep
2022-09,Washington,14454,16010,10922,3098,30030,2022,Sep
2022-09,West Virginia,1958,4688,5536,278,10502,2022,Sep
2022-09,Wisconsin,17279,17356,15300,1044,33700,2022,Sep
2022-09,Wyoming,663,2194,2354,162,4710,2022,Sep
2022-08,Alabama,20271,18400,13679,1315,33394,2022,Aug
2022-08,Alaska,291,3225,3005,373,6603,2022,Aug
2022-08,Arizona,8278,19079,9304,1947,30330,2022,Aug
2022-08,Arkansas,2585,6885,5697,516,13098,2022,Aug
2022-08,California,39274,39236,25005,5743,69984,2022,Aug
2022-08,Colorado,7271,20557,13165,1812,35534,2022,Aug
2022-08,Connecticut,9417,4111,1347,874,6332,2022,Aug
2022-08,Delaware,490,1913,910,104,2927,2022,Aug
2022-08,District of Columbia,1102,491,18,0,509,2022,Aug
2022-08,Florida,20897,60229,22654,5518,88401,2022,Aug
2022-08,Georgia,10902,18868,9588,949,29405,2022,Aug
2022-08,Guam,0,204,78,20,302,2022,Aug
2022-08,Hawaii,1716,0,0,0,0,2022,Aug
2022-08,Idaho,6012,5663,5167,575,11405,2022,Aug
2022-08,Illinois,346856,21278,10914,1214,33406,2022,Aug
2022-08,Indiana,339,23746,12311,1717,37774,2022,Aug
2022-08,Iowa,3571,2425,2684,151,5260,2022,Aug
2022-08,Kansas,1509,5954,5134,649,11737,2022,Aug
2022-08,Kentucky,797,9851,7604,645,18100,2022,Aug
2022-08,Louisiana,2424,12861,8514,1002,22377,2022,Aug
2022-08,Maine,658,3778,3866,399,8043,2022,Aug
2022-08,Mariana Islands,0,9,9,0,18,2022,Aug
2022-08,Maryland,16787,12452,5404,131,17987,2022,Aug
2022-08,Massachusetts,9865,5608,2939,1306,9853,2022,Aug
2022-08,Michigan,18326,19504,15053,1908,36465,2022,Aug
2022-08,Minnesota,13461,11079,11982,1096,24157,2022,Aug
2022-08,Mississippi,2651,10282,8410,574,19266,2022,Aug
2022-08,Missouri,1199,18675,14329,1948,34952,2022,Aug
2022-08,Montana,891,4301,4340,382,9023,2022,Aug
2022-08,Nebraska,3954,107,1620,16,1743,2022,Aug
2022-08,Nevada,2555,5591,2426,387,8404,2022,Aug
2022-08,New Hampshire,1103,5954,3293,324,9571,2022,Aug
2022-08,New Jersey,0,10281,4003,1002,15286,2022,Aug
2022-08,New Mexico,1165,7463,4335,733,12531,2022,Aug
2022-08,New York,5060,12197,23170,4325,39692,2022,Aug
2022-08,North Carolina,29181,1571,12808,1231,15610,2022,Aug
2022-08,North Dakota,736,1900,2753,175,4828,2022,Aug
2022-08,Ohio,5805,23314,13691,1581,38586,2022,Aug
2022-08,Oklahoma,2989,12065,8538,1471,22074,2022,Aug
2022-08,Oregon,5007,15535,9139,0,24674,2022,Aug
2022-08,Pennsylvania,32791,43173,19780,42,62995,2022,Aug
2022-08,Puerto Rico,0,4808,352,53,5213,2022,Aug
2022-08,Rhode Island,0,1144,676,115,1935,2022,Aug
2022-08,South Carolina,12135,10679,6543,823,18045,2022,Aug
2022-08,South Dakota,1005,2282,3123,221,5626,2022,Aug
2022-08,Tennessee,18727,27877,16463,1898,46238,2022,Aug
2022-08,Texas,28662,57617,33989,4632,96238,2022,Aug
2022-08,Utah,12438,5251,4268,632,10151,2022,Aug
2022-08,Vermont,0,1595,1567,119,3281,2022,Aug
2022-08,Virgin Islands,263,38,4,0,42,2022,Aug
2022-08,Virginia,388,23927,14134,3586,41647,2022,Aug
2022-08,Washington,17390,16573,10248,3576,30397,2022,Aug
2022-08,West Virginia,2509,4730,4762,306,9798,2022,Aug
2022-08,Wisconsin,16577,17139,13028,1080,31247,2022,Aug
2022-08,Wyoming,239,2325,2137,208,4670,2022,Aug
2022-07,Alabama,18043,18732,11235,1411,31378,2022,Jul
2022-07,Alaska,107,3200,2486,314,6000,2022,Jul
2022-07,Arizona,7730,19301,8868,1998,30167,2022,Jul
2022-07,Arkansas,2210,6626,4388,478,11492,2022,Jul
2022-07,California,22621,41159,23489,6090,70738,2022,Jul
2022-07,Colorado,6833,18940,11365,1789,32094,2022,Jul
2022-07,Connecticut,7905,4688,1358,986,7032,2022,Jul
2022-07,Delaware,440,2023,886,83,2992,2022,Jul
2022-07,District of Columbia,856,379,12,0,391,2022,Jul
2022-07,Florida,22162,61996,21087,5289,88372,2022,Jul
2022-07,Georgia,10149,19307,7697,928,27932,2022,Jul
2022-07,Guam,0,185,97,12,294,2022,Jul
2022-07,Hawaii,1827,0,0,0,0,2022,Jul
2022-07,Idaho,6245,5819,4576,684,11079,2022,Jul
2022-07,Illinois,295349,20758,9843,1133,31734,2022,Jul
2022-07,Indiana,386,25699,10652,1683,38034,2022,Jul
2022-07,Iowa,3041,2594,2292,125,5011,2022,Jul
2022-07,Kansas,1124,6433,4363,652,11448,2022,Jul
2022-07,Kentucky,630,10184,6714,642,17540,2022,Jul
2022-07,Louisiana,1737,12568,6411,1028,20007,2022,Jul
2022-07,Maine,595,3976,3326,389,7691,2022,Jul
2022-07,Mariana Islands,0,7,10,0,17,2022,Jul
2022-07,Maryland,6252,9712,5211,120,15043,2022,Jul
2022-07,Massachusetts,9998,5032,2542,1167,8741,2022,Jul
2022-07,Michigan,16243,20700,12962,1895,35557,2022,Jul
2022-07,Minnesota,11428,10166,8655,1004,19825,2022,Jul
2022-07,Mississippi,2310,8178,4903,481,13562,2022,Jul
2022-07,Missouri,1078,19786,12698,2091,34575,2022,Jul
2022-07,Montana,832,4333,3870,357,8560,2022,Jul
2022-07,Nebraska,3125,130,1397,19,1546,2022,Jul
2022-07,Nevada,3194,5284,2221,409,7914,2022,Jul
2022-07,New Hampshire,865,5940,3031,408,9379,2022,Jul
2022-07,New Jersey,0,9460,3963,926,14349,2022,Jul
2022-07,New Mexico,683,6740,3797,620,11157,2022,Jul
2022-07,New York,4005,10691,14983,3286,28960,2022,Jul
2022-07,North Carolina,25762,1928,11528,1229,14685,2022,Jul
2022-07,North Dakota,977,1840,2386,180,4406,2022,Jul
2022-07,Ohio,5680,25780,12538,1537,39855,2022,Jul
2022-07,Oklahoma,2941,12381,7220,1429,21030,2022,Jul
2022-07,Oregon,5627,15740,8659,0,24399,2022,Jul
2022-07,Pennsylvania,31640,42923,18194,40,61157,2022,Jul
2022-07,Puerto Rico,0,4631,333,49,5013,2022,Jul
2022-07,Rhode Island,0,1069,579,80,1728,2022,Jul
2022-07,South Carolina,10255,10964,5364,837,17165,2022,Jul
2022-07,South Dakota,1054,2175,2375,196,4746,2022,Jul
2022-07,Tennessee,18356,28300,14569,1971,44840,2022,Jul
2022-07,Texas,29812,60260,27696,4489,92445,2022,Jul
2022-07,Utah,10390,5319,4111,696,10126,2022,Jul
2022-07,Vermont,0,1668,1410,127,3205,2022,Jul
2022-07,Virgin Islands,119,61,0,1,62,2022,Jul
2022-07,Virginia,367,25758,13491,3582,42831,2022,Jul
2022-07,Washington,16305,22666,11347,3871,37884,2022,Jul
2022-07,West Virginia,2009,5109,4504,308,9921,2022,Jul
2022-07,Wisconsin,16179,16943,10414,1123,28480,2022,Jul
2022-07,Wyoming,393,2167,1990,200,4357,2022,Jul
2022-06,Alabama,19380,20615,12473,1670,34758,2022,Jun
2022-06,Alaska,225,3265,2451,355,6071,2022,Jun
2022-06,Arizona,7912,21680,10684,2246,34610,2022,Jun
2022-06,Arkansas,2495,7462,4881,624,12967,2022,Jun
2022-06,California,20367,43113,27018,7422,77553,2022,Jun
2022-06,Colorado,7284,20602,12857,2061,35520,2022,Jun
2022-06,Connecticut,6991,5869,1730,1419,9018,2022,Jun
2022-06,Delaware,622,3504,3475,1419,8398,2022,Jun
2022-06,District of Columbia,496,406,12,0,418,2022,Jun
2022-06,Florida,23118,70236,26816,6465,103517,2022,Jun
2022-06,Georgia,11995,21178,8667,1114,30959,2022,Jun
2022-06,Guam,0,199,79,20,298,2022,Jun
2022-06,Hawaii,1856,0,0,0,0,2022,Jun
2022-06,Idaho,6422,6832,5661,792,13285,2022,Jun
2022-06,Illinois,281728,21912,10229,1204,33345,2022,Jun
2022-06,Indiana,407,22310,11461,2008,35779,2022,Jun
2022-06,Iowa,3863,2885,2360,158,5403,2022,Jun
2022-06,Kansas,1498,6912,4901,806,12619,2022,Jun
2022-06,Kentucky,662,10740,7033,763,18536,2022,Jun
2022-06,Louisiana,2392,13840,6700,1105,21645,2022,Jun
2022-06,Maine,495,4447,3773,437,8657,2022,Jun
2022-06,Mariana Islands,0,14,13,1,28,2022,Jun
2022-06,Maryland,4126,8401,5951,188,14540,2022,Jun
2022-06,Massachusetts,8118,5734,2910,1325,9969,2022,Jun
2022-06,Michigan,17566,22279,14440,2341,39060,2022,Jun
2022-06,Minnesota,13386,10511,8650,1158,20319,2022,Jun
2022-06,Mississippi,2617,8976,5134,556,14666,2022,Jun
2022-06,Missouri,1107,20382,13146,2377,35905,2022,Jun
2022-06,Montana,1007,5015,4597,419,10031,2022,Jun
2022-06,Nebraska,3899,115,1487,25,1627,2022,Jun
2022-06,Nevada,4908,6351,2926,497,9774,2022,Jun
2022-06,New Hampshire,905,6688,3396,354,10438,2022,Jun
2022-06,New Jersey,0,6813,5022,978,12813,2022,Jun
2022-06,New Mexico,519,7367,4361,823,12551,2022,Jun
2022-06,New York,4055,11860,19130,5930,36920,2022,Jun
2022-06,North Carolina,30651,1819,13030,1398,16247,2022,Jun
2022-06,North Dakota,1178,1799,2311,165,4275,2022,Jun
2022-06,Ohio,6801,29208,13273,1636,44117,2022,Jun
2022-06,Oklahoma,2700,14288,8281,1887,24456,2022,Jun
2022-06,Oregon,5916,17867,10391,0,28258,2022,Jun
2022-06,Pennsylvania,34445,48211,20917,38,69166,2022,Jun
2022-06,Puerto Rico,0,5585,437,48,6070,2022,Jun
2022-06,Rhode Island,0,1457,897,129,2483,2022,Jun
2022-06,South Carolina,13630,12819,5822,873,19514,2022,Jun
2022-06,South Dakota,617,2244,2517,207,4968,2022,Jun
2022-06,Tennessee,18559,30112,15782,2142,48036,2022,Jun
2022-06,Texas,30240,69148,32349,5487,106984,2022,Jun
2022-06,Utah,13335,6333,4920,756,12009,2022,Jun
2022-06,Vermont,0,1767,1517,136,3420,2022,Jun
2022-06,Virgin Islands,241,44,3,0,47,2022,Jun
2022-06,Virginia,308,27252,14648,4171,46071,2022,Jun
2022-06,Washington,16440,38603,16561,5553,60717,2022,Jun
2022-06,West Virginia,2165,5662,4539,344,10545,2022,Jun
2022-06,Wisconsin,15128,17974,11110,1323,30407,2022,Jun
2022-06,Wyoming,487,2463,2412,228,5103,2022,Jun
2022-05,Alabama,17637,18288,10569,1085,29942,2022,May
2022-05,Alaska,207,3193,2463,303,5959,2022,May
2022-05,Arizona,9868,18297,8087,1511,27895,2022,May
2022-05,Arkansas,2496,6381,4276,327,10984,2022,May
2022-05,California,18159,37659,23729,5143,66531,2022,May
2022-05,Colorado,6357,19421,11234,1495,32150,2022,May
2022-05,Connecticut,9520,5463,1585,1087,8135,2022,May
2022-05,Delaware,579,2071,1209,163,3443,2022,May
2022-05,District of Columbia,479,369,11,0,380,2022,May
2022-05,Florida,19022,59519,20002,4408,83929,2022,May
2022-05,Georgia,10324,20689,7238,779,28706,2022,May
2022-05,Guam,0,190,72,15,277,2022,May
2022-05,Hawaii,1331,0,0,0,0,2022,May
2022-05,Idaho,5887,6062,5228,569,11859,2022,May
2022-05,Illinois,249554,19865,8639,1031,29535,2022,May
2022-05,Indiana,379,19617,9957,1372,30946,2022,May
2022-05,Iowa,3302,2321,2191,129,4641,2022,May
2022-05,Kansas,1543,5867,4046,499,10412,2022,May
2022-05,Kentucky,673,9753,6567,505,16825,2022,May
2022-05,Louisiana,2025,12405,5438,771,18614,2022,May
2022-05,Maine,524,3457,2937,309,6703,2022,May
2022-05,Mariana Islands,0,17,26,1,44,2022,May
2022-05,Maryland,4251,7645,5276,123,13044,2022,May
2022-05,Massachusetts,8416,5041,2508,1009,8558,2022,May
2022-05,Michigan,17208,20573,12514,1690,34777,2022,May
2022-05,Minnesota,13299,10715,9157,924,20796,2022,May
2022-05,Mississippi,2358,8395,4393,457,13245,2022,May
2022-05,Missouri,1087,18363,11898,1790,32051,2022,May
2022-05,Montana,1035,4375,4513,352,9240,2022,May
2022-05,Nebraska,3848,111,1269,21,1401,2022,May
2022-05,Nevada,2734,5586,2413,380,8379,2022,May
2022-05,New Hampshire,833,5392,2822,248,8462,2022,May
2022-05,New Jersey,0,6682,3955,813,11450,2022,May
2022-05,New Mexico,628,6612,3775,514,10901,2022,May
2022-05,New York,3980,9679,12756,1771,24206,2022,May
2022-05,North Carolina,27642,1579,10792,1044,13415,2022,May
2022-05,North Dakota,884,1882,2246,144,4272,2022,May
2022-05,Ohio,7224,22495,11534,1208,35237,2022,May
2022-05,Oklahoma,2023,11879,6871,1232,19982,2022,May
2022-05,Oregon,5617,15483,8842,0,24325,2022,May
2022-05,Pennsylvania,29483,41014,17026,64,58104,2022,May
2022-05,Puerto Rico,0,5790,401,50,6241,2022,May
2022-05,Rhode Island,0,1086,680,78,1844,2022,May
2022-05,South Carolina,10172,11806,4936,632,17374,2022,May
2022-05,South Dakota,693,2096,2240,173,4509,2022,May
2022-05,Tennessee,19591,26402,12876,1737,41015,2022,May
2022-05,Texas,24665,61073,26898,3881,91852,2022,May
2022-05,Utah,10735,5366,4129,482,9977,2022,May
2022-05,Vermont,0,1396,1287,97,2780,2022,May
2022-05,Virgin Islands,150,31,1,0,32,2022,May
2022-05,Virginia,248,24118,12268,3224,39610,2022,May
2022-05,Washington,18511,26620,12272,3925,42817,2022,May
2022-05,West Virginia,1898,4907,4298,273,9478,2022,May
2022-05,Wisconsin,14717,15938,10604,1050,27592,2022,May
2022-05,Wyoming,476,2421,2148,170,4739,2022,May
2022-04,Alabama,16150,20593,12513,1249,34355,2022,Apr
2022-04,Alaska,354,3425,2946,391,6762,2022,Apr
2022-04,Arizona,25746,20628,9300,1814,31742,2022,Apr
2022-04,Arkansas,2043,7659,5376,483,13518,2022,Apr
2022-04,California,17944,38217,25572,5595,69384,2022,Apr
2022-04,Colorado,7092,20608,12516,1799,34923,2022,Apr
2022-04,Connecticut,12713,6064,1909,1684,9657,2022,Apr
2022-04,Delaware,707,2326,1357,178,3861,2022,Apr
2022-04,District of Columbia,606,538,20,1,559,2022,Apr
2022-04,Florida,22255,65359,22430,4912,92701,2022,Apr
2022-04,Georgia,12112,22500,8495,849,31844,2022,Apr
2022-04,Guam,0,199,82,23,304,2022,Apr
2022-04,Hawaii,1450,0,0,0,0,2022,Apr
2022-04,Idaho,5386,6581,5795,677,13053,2022,Apr
2022-04,Illinois,267196,24064,10548,1178,35790,2022,Apr
2022-04,Indiana,908,24086,13122,1933,39141,2022,Apr
2022-04,Iowa,4032,2818,3058,159,6035,2022,Apr
2022-04,Kansas,1451,6989,4915,656,12560,2022,Apr
2022-04,Kentucky,809,11609,8991,601,21201,2022,Apr
2022-04,Louisiana,2555,13978,6119,914,21011,2022,Apr
2022-04,Maine,481,4245,3802,394,8441,2022,Apr
2022-04,Mariana Islands,0,19,10,1,30,2022,Apr
2022-04,Maryland,4965,7795,6062,136,13993,2022,Apr
2022-04,Massachusetts,7916,5671,3282,1287,10240,2022,Apr
2022-04,Michigan,18227,25891,17597,2303,45791,2022,Apr
2022-04,Minnesota,16124,14559,13987,1228,29774,2022,Apr
2022-04,Mississippi,2352,10141,5599,539,16279,2022,Apr
2022-04,Missouri,1332,21431,16216,2080,39727,2022,Apr
2022-04,Montana,1188,4796,4978,422,10196,2022,Apr
2022-04,Nebraska,4653,154,1631,20,1805,2022,Apr
2022-04,Nevada,1498,6004,2624,437,9065,2022,Apr
2022-04,New Hampshire,1166,6657,3648,226,10531,2022,Apr
2022-04,New Jersey,0,7844,4643,1059,13546,2022,Apr
2022-04,New Mexico,450,7274,4568,600,12442,2022,Apr
2022-04,New York,3806,11120,16284,2178,29582,2022,Apr
2022-04,North Carolina,27640,1655,12435,1148,15238,2022,Apr
2022-04,North Dakota,730,2128,2837,198,5163,2022,Apr
2022-04,Ohio,8958,27592,15402,1585,44579,2022,Apr
2022-04,Oklahoma,1851,14118,8899,1579,24596,2022,Apr
2022-04,Oregon,5527,17115,10539,0,27654,2022,Apr
2022-04,Pennsylvania,30311,49384,21978,59,71421,2022,Apr
2022-04,Puerto Rico,0,4724,355,49,5128,2022,Apr
2022-04,Rhode Island,0,1251,788,88,2127,2022,Apr
2022-04,South Carolina,12445,12404,5569,746,18719,2022,Apr
2022-04,South Dakota,885,2693,3077,223,5993,2022,Apr
2022-04,Tennessee,20346,29042,16037,1805,46884,2022,Apr
2022-04,Texas,28691,64582,28526,4137,97245,2022,Apr
2022-04,Utah,12062,5844,4761,676,11281,2022,Apr
2022-04,Vermont,0,1772,1897,140,3809,2022,Apr
2022-04,Virgin Islands,103,40,4,0,44,2022,Apr
2022-04,Virginia,385,26441,15143,3368,44952,2022,Apr
2022-04,Washington,17289,28741,13744,4558,47043,2022,Apr
2022-04,West Virginia,1809,5647,5719,358,11724,2022,Apr
2022-04,Wisconsin,14934,20876,16225,1303,38404,2022,Apr
2022-04,Wyoming,507,2490,2191,206,4887,2022,Apr
2022-03,Alabama,25133,26999,17011,1649,45659,2022,Mar
2022-03,Alaska,284,3466,2992,456,6914,2022,Mar
2022-03,Arizona,5647,25129,12035,2067,39231,2022,Mar
2022-03,Arkansas,2664,10601,7085,669,18355,2022,Mar
2022-03,California,19327,43976,29658,6490,80124,2022,Mar
2022-03,Colorado,9295,23755,15419,1985,41159,2022,Mar
2022-03,Connecticut,11109,7365,2562,4358,14285,2022,Mar
2022-03,Delaware,699,2836,1710,198,4744,2022,Mar
2022-03,District of Columbia,876,609,15,0,624,2022,Mar
2022-03,Florida,24317,71992,28469,5182,105643,2022,Mar
2022-03,Georgia,21664,25478,11240,949,37667,2022,Mar
2022-03,Guam,0,212,106,18,336,2022,Mar
2022-03,Hawaii,1779,0,0,0,0,2022,Mar
2022-03,Idaho,7838,7679,6750,730,15159,2022,Mar
2022-03,Illinois,339247,30013,14121,1649,45783,2022,Mar
2022-03,Indiana,1399,30469,16666,2365,49500,2022,Mar
2022-03,Iowa,5858,4005,4083,201,8289,2022,Mar
2022-03,Kansas,1469,9230,6615,901,16746,2022,Mar
2022-03,Kentucky,807,15620,11957,822,28399,2022,Mar
2022-03,Louisiana,3465,19917,8678,1231,29826,2022,Mar
2022-03,Maine,692,5138,4686,481,10305,2022,Mar
2022-03,Mariana Islands,0,10,13,3,26,2022,Mar
2022-03,Maryland,4974,8955,7485,139,16579,2022,Mar
2022-03,Massachusetts,9957,7373,4314,1557,13244,2022,Mar
2022-03,Michigan,20983,30844,21167,2597,54608,2022,Mar
2022-03,Minnesota,21065,15715,14303,1340,31358,2022,Mar
2022-03,Mississippi,2950,14080,8203,667,22950,2022,Mar
2022-03,Missouri,1669,27618,20103,2688,50409,2022,Mar
2022-03,Montana,1370,5447,5453,437,11337,2022,Mar
2022-03,Nebraska,5410,176,2256,49,2481,2022,Mar
2022-03,Nevada,2857,7657,3379,482,11518,2022,Mar
2022-03,New Hampshire,1052,7570,4308,389,12267,2022,Mar
2022-03,New Jersey,0,9276,6845,838,16959,2022,Mar
2022-03,New Mexico,887,9068,5781,773,15622,2022,Mar
2022-03,New York,5106,12638,18735,2804,34177,2022,Mar
2022-03,North Carolina,40807,1968,17087,1563,20618,2022,Mar
2022-03,North Dakota,1145,2629,3442,224,6295,2022,Mar
2022-03,Ohio,13336,35780,18954,2044,56778,2022,Mar
2022-03,Oklahoma,2379,16924,11028,1862,29814,2022,Mar
2022-03,Oregon,7209,19399,12285,0,31684,2022,Mar
2022-03,Pennsylvania,39213,58010,25770,53,83833,2022,Mar
2022-03,Puerto Rico,0,6095,438,74,6607,2022,Mar
2022-03,Rhode Island,0,1614,1061,137,2812,2022,Mar
2022-03,South Carolina,14418,16840,7787,906,25533,2022,Mar
2022-03,South Dakota,1222,3120,3694,288,7102,2022,Mar
2022-03,Tennessee,26109,36454,20535,2205,59194,2022,Mar
2022-03,Texas,28868,82218,37664,5214,125096,2022,Mar
2022-03,Utah,13866,6989,5987,733,13709,2022,Mar
2022-03,Vermont,0,2342,2188,155,4685,2022,Mar
2022-03,Virgin Islands,113,40,4,1,45,2022,Mar
2022-03,Virginia,437,31656,18081,4033,53770,2022,Mar
2022-03,Washington,19656,34398,16494,5437,56329,2022,Mar
2022-03,West Virginia,2623,7318,7219,420,14957,2022,Mar
2022-03,Wisconsin,16732,26415,18554,1476,46445,2022,Mar
2022-03,Wyoming,647,2946,2522,232,5700,2022,Mar
2022-02,Alabama,25401,21822,14541,1351,37714,2022,Feb
2022-02,Alaska,301,2644,2178,348,5170,2022,Feb
2022-02,Arizona,2560,20150,9935,1690,31775,2022,Feb
2022-02,Arkansas,1842,7780,5756,429,13965,2022,Feb
2022-02,California,15815,36362,23017,4941,64320,2022,Feb
2022-02,Colorado,7055,19591,12402,1590,33583,2022,Feb
2022-02,Connecticut,8289,6248,1862,2845,10955,2022,Feb
2022-02,Delaware,605,2536,1427,168,4131,2022,Feb
2022-02,District of Columbia,556,463,13,0,476,2022,Feb
2022-02,Florida,21335,61461,23989,4261,89711,2022,Feb
2022-02,Georgia,19760,19910,9363,809,30082,2022,Feb
2022-02,Guam,0,161,98,17,276,2022,Feb
2022-02,Hawaii,1327,0,0,0,0,2022,Feb
2022-02,Idaho,6400,6309,5577,614,12500,2022,Feb
2022-02,Illinois,272525,23796,10762,1186,35744,2022,Feb
2022-02,Indiana,1013,22916,13065,1803,37784,2022,Feb
2022-02,Iowa,5667,2953,2912,133,5998,2022,Feb
2022-02,Kansas,1021,7825,5774,706,14305,2022,Feb
2022-02,Kentucky,580,13175,9793,649,23617,2022,Feb
2022-02,Louisiana,3639,15729,7504,936,24169,2022,Feb
2022-02,Maine,526,3873,3286,357,7516,2022,Feb
2022-02,Mariana Islands,0,15,10,2,27,2022,Feb
2022-02,Maryland,4287,7838,6251,142,14231,2022,Feb
2022-02,Massachusetts,7868,5625,3092,1188,9905,2022,Feb
2022-02,Michigan,15690,23315,14903,2006,40224,2022,Feb
2022-02,Minnesota,13484,12015,9786,1065,22866,2022,Feb
2022-02,Mississippi,2543,12172,7674,551,20397,2022,Feb
2022-02,Missouri,906,21511,15343,2145,38999,2022,Feb
2022-02,Montana,989,4348,3898,332,8578,2022,Feb
2022-02,Nebraska,4477,177,1880,30,2087,2022,Feb
2022-02,Nevada,2523,5216,2200,334,7750,2022,Feb
2022-02,New Hampshire,577,6067,3139,281,9487,2022,Feb
2022-02,New Jersey,0,7111,4675,729,12515,2022,Feb
2022-02,New Mexico,701,7176,4392,552,12120,2022,Feb
2022-02,New York,3515,10153,13758,2056,25967,2022,Feb
2022-02,North Carolina,34544,1881,14517,1146,17544,2022,Feb
2022-02,North Dakota,718,1987,2353,169,4509,2022,Feb
2022-02,Ohio,10572,24245,14659,1633,40537,2022,Feb
2022-02,Oklahoma,1664,13521,8883,1430,23834,2022,Feb
2022-02,Oregon,5445,16029,9998,0,26027,2022,Feb
2022-02,Pennsylvania,32399,50228,21323,50,71601,2022,Feb
2022-02,Puerto Rico,0,4923,352,56,5331,2022,Feb
2022-02,Rhode Island,0,1314,770,101,2185,2022,Feb
2022-02,South Carolina,14217,14151,6676,812,21639,2022,Feb
2022-02,South Dakota,1003,2598,2936,242,5776,2022,Feb
2022-02,Tennessee,23674,32612,17688,2030,52330,2022,Feb
2022-02,Texas,22014,66796,31364,4328,102488,2022,Feb
2022-02,Utah,10362,5539,4559,497,10595,2022,Feb
2022-02,Vermont,0,1892,1578,99,3569,2022,Feb
2022-02,Virgin Islands,142,56,6,0,62,2022,Feb
2022-02,Virginia,411,27730,15827,3433,46990,2022,Feb
2022-02,Washington,16339,21232,11858,3661,36751,2022,Feb
2022-02,West Virginia,1887,6158,5952,387,12497,2022,Feb
2022-02,Wisconsin,16038,22686,13537,1122,37345,2022,Feb
2022-02,Wyoming,354,2473,2227,203,4903,2022,Feb
2022-01,Alabama,26820,17571,12669,1524,31764,2022,Jan
2022-01,Alaska,104,2248,1872,393,4513,2022,Jan
2022-01,Arizona,3034,18333,8655,1775,28763,2022,Jan
2022-01,Arkansas,2324,6355,5674,498,12527,2022,Jan
2022-01,California,15010,36971,24010,5150,66131,2022,Jan
2022-01,Colorado,7817,18435,11107,1758,31300,2022,Jan
2022-01,Connecticut,8669,5790,1803,896,8489,2022,Jan
2022-01,Delaware,512,2140,1412,189,3741,2022,Jan
2022-01,District of Columbia,930,434,17,0,451,2022,Jan
2022-01,Florida,18451,57833,23109,4678,85620,2022,Jan
2022-01,Georgia,19849,15651,8724,927,25302,2022,Jan
2022-01,Guam,0,162,83,17,262,2022,Jan
2022-01,Hawaii,1352,0,0,0,0,2022,Jan
2022-01,Idaho,4785,5360,4418,593,10371,2022,Jan
2022-01,Illinois,440424,22564,9950,1015,33529,2022,Jan
2022-01,Indiana,1287,21402,12343,2205,35950,2022,Jan
2022-01,Iowa,5661,2307,2377,171,4855,2022,Jan
2022-01,Kansas,1123,6297,5293,779,12369,2022,Jan
2022-01,Kentucky,657,9894,7487,634,18015,2022,Jan
2022-01,Louisiana,4588,12253,7529,1007,20789,2022,Jan
2022-01,Maine,562,3391,2614,371,6376,2022,Jan
2022-01,Mariana Islands,0,24,16,1,41,2022,Jan
2022-01,Maryland,4157,7033,5700,119,12852,2022,Jan
2022-01,Massachusetts,7812,5244,2765,1126,9135,2022,Jan
2022-01,Michigan,17041,21493,13790,2372,37655,2022,Jan
2022-01,Minnesota,13021,10750,8032,1092,19874,2022,Jan
2022-01,Mississippi,2086,8048,6372,589,15009,2022,Jan
2022-01,Missouri,1210,18427,13713,2258,34398,2022,Jan
2022-01,Montana,1038,3388,3343,350,7081,2022,Jan
2022-01,Nebraska,3940,148,1647,39,1834,2022,Jan
2022-01,Nevada,3518,5878,2687,435,9000,2022,Jan
2022-01,New Hampshire,590,5608,2922,254,8784,2022,Jan
2022-01,New Jersey,0,7448,4914,559,12921,2022,Jan
2022-01,New Mexico,746,6193,3740,722,10655,2022,Jan
2022-01,New York,3350,9203,12239,1802,23244,2022,Jan
2022-01,North Carolina,32363,1662,12250,1190,15102,2022,Jan
2022-01,North Dakota,905,1682,2108,151,3941,2022,Jan
2022-01,Ohio,11385,21582,13064,1956,36602,2022,Jan
2022-01,Oklahoma,2057,12042,8262,1532,21836,2022,Jan
2022-01,Oregon,5746,14986,8682,0,23668,2022,Jan
2022-01,Pennsylvania,31744,41927,18418,16,60361,2022,Jan
2022-01,Puerto Rico,0,4433,279,50,4762,2022,Jan
2022-01,Rhode Island,0,1142,666,91,1899,2022,Jan
2022-01,South Carolina,10332,10143,5864,939,16946,2022,Jan
2022-01,South Dakota,1032,2191,2685,231,5107,2022,Jan
2022-01,Tennessee,18354,26275,15442,1623,43340,2022,Jan
2022-01,Texas,23857,58532,29742,4491,92765,2022,Jan
2022-01,Utah,10377,4784,3746,500,9030,2022,Jan
2022-01,Vermont,0,1556,1384,141,3081,2022,Jan
2022-01,Virgin Islands,69,15,3,1,19,2022,Jan
2022-01,Virginia,321,23681,14124,3491,41296,2022,Jan
2022-01,Washington,15482,20809,10856,3472,35137,2022,Jan
2022-01,West Virginia,1759,4547,4850,422,9819,2022,Jan
2022-01,Wisconsin,21156,17403,10674,1286,29363,2022,Jan
2022-01,Wyoming,407,1967,1848,209,4024,2022,Jan
2021-12,Alabama,27674,30428,26932,1875,59235,2021,Dec
2021-12,Alaska,41,3448,3216,481,7145,2021,Dec
2021-12,Arizona,3106,25636,13507,2135,41278,2021,Dec
2021-12,Arkansas,2197,11633,11675,717,24025,2021,Dec
2021-12,California,15528,46627,31488,5894,84009,2021,Dec
2021-12,Colorado,7671,24959,17729,2067,44755,2021,Dec
2021-12,Connecticut,8367,7023,2256,1063,10342,2021,Dec
2021-12,Delaware,213,2936,2435,212,5583,2021,Dec
2021-12,District of Columbia,750,478,8,0,486,2021,Dec
2021-12,Florida,20720,77064,36710,5904,119678,2021,Dec
2021-12,Georgia,20768,24587,18223,1131,43941,2021,Dec
2021-12,Guam,0,242,114,15,371,2021,Dec
2021-12,Hawaii,1458,0,0,0,0,2021,Dec
2021-12,Idaho,5183,9253,8389,808,18450,2021,Dec
2021-12,Illinois,392738,29123,14315,1471,44909,2021,Dec
2021-12,Indiana,1351,29183,20059,2676,51918,2021,Dec
2021-12,Iowa,5688,3190,4584,214,7988,2021,Dec
2021-12,Kansas,2020,9137,8877,868,18882,2021,Dec
2021-12,Kentucky,623,18288,16090,866,35244,2021,Dec
2021-12,Louisiana,2177,18564,16077,1224,35865,2021,Dec
2021-12,Maine,431,5199,5353,497,11049,2021,Dec
2021-12,Mariana Islands,0,19,14,4,37,2021,Dec
2021-12,Maryland,3783,8618,8842,148,17608,2021,Dec
2021-12,Massachusetts,6924,6416,3795,1147,11358,2021,Dec
2021-12,Michigan,15337,27809,22240,2853,52902,2021,Dec
2021-12,Minnesota,13927,12730,12495,1374,26599,2021,Dec
2021-12,Mississippi,2085,15182,15343,790,31315,2021,Dec
2021-12,Missouri,1447,28648,24331,2906,55885,2021,Dec
2021-12,Montana,810,5908,6586,392,12886,2021,Dec
2021-12,Nebraska,4405,227,3307,38,3572,2021,Dec
2021-12,Nevada,2852,6773,3338,491,10602,2021,Dec
2021-12,New Hampshire,683,7862,4217,282,12361,2021,Dec
2021-12,New Jersey,0,6835,5940,635,13410,2021,Dec
2021-12,New Mexico,520,9303,6090,759,16152,2021,Dec
2021-12,New York,3184,10289,20083,2149,32521,2021,Dec
2021-12,North Carolina,31504,2495,25331,1599,29425,2021,Dec
2021-12,North Dakota,624,2316,3123,193,5632,2021,Dec
2021-12,Ohio,12210,32597,24233,2522,59352,2021,Dec
2021-12,Oklahoma,1742,19342,16152,1834,37328,2021,Dec
2021-12,Oregon,5673,20150,12759,0,32909,2021,Dec
2021-12,Pennsylvania,31427,57822,30165,28,88015,2021,Dec
2021-12,Puerto Rico,0,5519,341,60,5920,2021,Dec
2021-12,Rhode Island,0,1407,952,104,2463,2021,Dec
2021-12,South Carolina,9070,17118,12506,1205,30829,2021,Dec
2021-12,South Dakota,901,2945,4466,273,7684,2021,Dec
2021-12,Tennessee,16748,42865,30049,2596,75510,2021,Dec
2021-12,Texas,22565,89626,54657,5594,149877,2021,Dec
2021-12,Utah,9915,8552,8075,605,17232,2021,Dec
2021-12,Vermont,0,2169,2106,137,4412,2021,Dec
2021-12,Virgin Islands,132,34,3,2,39,2021,Dec
2021-12,Virginia,296,33356,23898,4573,61827,2021,Dec
2021-12,Washington,18786,27276,16586,3724,47586,2021,Dec
2021-12,West Virginia,1596,8691,10447,506,19644,2021,Dec
2021-12,Wisconsin,24904,22744,15539,1416,39699,2021,Dec
2021-12,Wyoming,564,3605,3523,283,7411,2021,Dec
2021-11,Alabama,24489,22126,21230,1319,44675,2021,Nov
2021-11,Alaska,12,3162,3248,405,6815,2021,Nov
2021-11,Arizona,2913,20104,10905,1562,32571,2021,Nov
2021-11,Arkansas,1773,8036,10394,451,18881,2021,Nov
2021-11,California,14038,40966,29795,5177,75938,2021,Nov
2021-11,Colorado,7367,21290,16190,1581,39061,2021,Nov
2021-11,Connecticut,9184,6498,2355,1063,9916,2021,Nov
2021-11,Delaware,254,2389,2151,169,4709,2021,Nov
2021-11,District of Columbia,635,600,14,0,614,2021,Nov
2021-11,Florida,18570,65666,31575,4266,101507,2021,Nov
2021-11,Georgia,20172,18064,14404,800,33268,2021,Nov
2021-11,Guam,0,229,119,25,373,2021,Nov
2021-11,Hawaii,1567,0,0,0,0,2021,Nov
2021-11,Idaho,5854,7501,7729,588,15818,2021,Nov
2021-11,Illinois,262319,25791,14008,1552,41351,2021,Nov
2021-11,Indiana,1334,23950,19182,1769,44901,2021,Nov
2021-11,Iowa,5653,3157,4961,189,8307,2021,Nov
2021-11,Kansas,2058,7761,8310,607,16678,2021,Nov
2021-11,Kentucky,699,13586,14178,587,28351,2021,Nov
2021-11,Louisiana,2069,14553,14437,974,29964,2021,Nov
2021-11,Maine,510,3977,5350,342,9669,2021,Nov
2021-11,Mariana Islands,0,21,12,3,36,2021,Nov
2021-11,Maryland,3523,7664,8488,136,16288,2021,Nov
2021-11,Massachusetts,7361,5827,3635,1101,10563,2021,Nov
2021-11,Michigan,15508,24295,25535,1968,51798,2021,Nov
2021-11,Minnesota,14246,12307,13742,1123,27172,2021,Nov
2021-11,Mississippi,2173,10948,12904,528,24380,2021,Nov
2021-11,Missouri,1549,22588,22189,1965,46742,2021,Nov
2021-11,Montana,953,4444,5852,335,10631,2021,Nov
2021-11,Nebraska,3947,244,3041,33,3318,2021,Nov
2021-11,Nevada,2597,5504,2746,350,8600,2021,Nov
2021-11,New Hampshire,714,5987,3781,203,9971,2021,Nov
2021-11,New Jersey,0,7363,6285,612,14260,2021,Nov
2021-11,New Mexico,527,7177,5056,545,12778,2021,Nov
2021-11,New York,3292,9302,19645,1888,30835,2021,Nov
2021-11,North Carolina,30588,2142,20952,1094,24188,2021,Nov
2021-11,North Dakota,515,2023,3262,167,5452,2021,Nov
2021-11,Ohio,13688,26580,24593,1942,53115,2021,Nov
2021-11,Oklahoma,1682,15436,14390,1288,31114,2021,Nov
2021-11,Oregon,6207,17374,12000,0,29374,2021,Nov
2021-11,Pennsylvania,31113,47708,29011,25,76744,2021,Nov
2021-11,Puerto Rico,0,5704,356,44,6104,2021,Nov
2021-11,Rhode Island,0,1375,867,102,2344,2021,Nov
2021-11,South Carolina,10470,13038,10150,742,23930,2021,Nov
2021-11,South Dakota,761,2698,4569,226,7493,2021,Nov
2021-11,Tennessee,17439,33337,24647,2018,60002,2021,Nov
2021-11,Texas,18544,70441,44916,3960,119317,2021,Nov
2021-11,Utah,10006,6616,6972,477,14065,2021,Nov
2021-11,Vermont,0,1484,1957,117,3558,2021,Nov
2021-11,Virgin Islands,128,37,3,1,41,2021,Nov
2021-11,Virginia,447,28367,21788,3682,53837,2021,Nov
2021-11,Washington,16313,20304,14405,3092,37801,2021,Nov
2021-11,West Virginia,1633,6431,9913,303,16647,2021,Nov
2021-11,Wisconsin,25736,21011,17606,1151,39768,2021,Nov
2021-11,Wyoming,499,2816,3220,193,6229,2021,Nov
2021-10,Alabama,25822,19188,15531,1309,36028,2021,Oct
2021-10,Alaska,129,3242,3222,340,6804,2021,Oct
2021-10,Arizona,4170,18744,10232,1561,30537,2021,Oct
2021-10,Arkansas,2591,7360,7994,488,15842,2021,Oct
2021-10,California,15704,40185,28159,5364,73708,2021,Oct
2021-10,Colorado,7640,19992,15443,1553,36988,2021,Oct
2021-10,Connecticut,9173,6600,2211,1017,9828,2021,Oct
2021-10,Delaware,499,2421,1786,169,4376,2021,Oct
2021-10,District of Columbia,902,391,9,0,400,2021,Oct
2021-10,Florida,22246,63090,26371,4562,94023,2021,Oct
2021-10,Georgia,21421,17037,11458,736,29231,2021,Oct
2021-10,Guam,0,254,119,20,393,2021,Oct
2021-10,Hawaii,1564,0,0,0,0,2021,Oct
2021-10,Idaho,5306,6313,7018,586,13917,2021,Oct
2021-10,Illinois,213822,24172,12375,1311,37858,2021,Oct
2021-10,Indiana,1533,21585,15646,1904,39135,2021,Oct
2021-10,Iowa,4996,2701,3877,127,6705,2021,Oct
2021-10,Kansas,2234,6894,6529,660,14083,2021,Oct
2021-10,Kentucky,665,11884,10975,625,23484,2021,Oct
2021-10,Louisiana,2212,13922,11617,965,26504,2021,Oct
2021-10,Maine,531,4023,6684,310,11017,2021,Oct
2021-10,Mariana Islands,0,11,16,2,29,2021,Oct
2021-10,Maryland,3787,7387,7212,190,14789,2021,Oct
2021-10,Massachusetts,8233,5845,3584,1137,10566,2021,Oct
2021-10,Michigan,17268,23230,22133,2023,47386,2021,Oct
2021-10,Minnesota,16012,12235,17984,1092,31311,2021,Oct
2021-10,Mississippi,2280,9416,8429,513,18358,2021,Oct
2021-10,Missouri,1759,20788,19311,2012,42111,2021,Oct
2021-10,Montana,857,4398,7033,286,11717,2021,Oct
2021-10,Nebraska,3794,154,2443,26,2623,2021,Oct
2021-10,Nevada,3352,5591,2812,368,8771,2021,Oct
2021-10,New Hampshire,693,6058,4240,225,10523,2021,Oct
2021-10,New Jersey,0,7463,5646,617,13726,2021,Oct
2021-10,New Mexico,558,6893,4845,594,12332,2021,Oct
2021-10,New York,3241,9842,19469,1999,31310,2021,Oct
2021-10,North Carolina,30183,1629,16638,1196,19463,2021,Oct
2021-10,North Dakota,672,2040,4154,164,6358,2021,Oct
2021-10,Ohio,14963,23158,18255,1983,43396,2021,Oct
2021-10,Oklahoma,1944,12742,10459,1186,24387,2021,Oct
2021-10,Oregon,6416,16364,11536,0,27900,2021,Oct
2021-10,Pennsylvania,32577,50185,25812,22,76019,2021,Oct
2021-10,Puerto Rico,0,5653,321,60,6034,2021,Oct
2021-10,Rhode Island,0,1227,812,88,2127,2021,Oct
2021-10,South Carolina,13265,11714,8052,726,20492,2021,Oct
2021-10,South Dakota,917,2465,5863,233,8561,2021,Oct
2021-10,Tennessee,16656,30555,19445,1856,51856,2021,Oct
2021-10,Texas,23384,67440,38737,4157,110334,2021,Oct
2021-10,Utah,12664,5301,5380,430,11111,2021,Oct
2021-10,Vermont,0,1726,2287,102,4115,2021,Oct
2021-10,Virgin Islands,103,50,1,0,51,2021,Oct
2021-10,Virginia,360,26469,18466,3477,48412,2021,Oct
2021-10,Washington,19560,20684,15051,3115,38850,2021,Oct
2021-10,West Virginia,1698,5589,7192,347,13128,2021,Oct
2021-10,Wisconsin,27177,20452,17955,1102,39509,2021,Oct
2021-10,Wyoming,355,2127,2920,162,5209,2021,Oct
2021-09,Alabama,26657,18034,15390,1365,34789,2021,Sep
2021-09,Alaska,174,2497,3094,310,5901,2021,Sep
2021-09,Arizona,5962,18406,10477,1769,30652,2021,Sep
2021-09,Arkansas,3259,6946,6783,495,14224,2021,Sep
2021-09,California,17520,37842,27880,6190,71912,2021,Sep
2021-09,Colorado,8741,19018,14169,1696,34883,2021,Sep
2021-09,Connecticut,7727,5798,1894,881,8573,2021,Sep
2021-09,Delaware,382,2032,1624,148,3804,2021,Sep
2021-09,District of Columbia,708,340,3,0,343,2021,Sep
2021-09,Florida,24490,59728,25555,5125,90408,2021,Sep
2021-09,Georgia,22036,16398,10300,885,27583,2021,Sep
2021-09,Guam,0,252,102,23,377,2021,Sep
2021-09,Hawaii,1673,0,0,0,0,2021,Sep
2021-09,Idaho,4610,5786,6826,561,13173,2021,Sep
2021-09,Illinois,312148,22461,11566,1287,35314,2021,Sep
2021-09,Indiana,1756,20859,14814,1857,37530,2021,Sep
2021-09,Iowa,4712,2379,3058,128,5565,2021,Sep
2021-09,Kansas,2767,6240,5887,665,12792,2021,Sep
2021-09,Kentucky,703,10921,9383,586,20890,2021,Sep
2021-09,Louisiana,1678,11884,9985,852,22721,2021,Sep
2021-09,Maine,565,4036,6058,355,10449,2021,Sep
2021-09,Mariana Islands,0,28,23,2,53,2021,Sep
2021-09,Maryland,3700,7196,6536,140,13872,2021,Sep
2021-09,Massachusetts,7931,5954,3487,1065,10506,2021,Sep
2021-09,Michigan,17459,22956,21452,2140,46548,2021,Sep
2021-09,Minnesota,16079,11308,16661,1107,29076,2021,Sep
2021-09,Mississippi,2310,8757,7648,510,16915,2021,Sep
2021-09,Missouri,2097,19206,16266,2007,37479,2021,Sep
2021-09,Montana,839,4194,5625,326,10145,2021,Sep
2021-09,Nebraska,3899,129,2084,30,2243,2021,Sep
2021-09,Nevada,2864,5782,2918,407,9107,2021,Sep
2021-09,New Hampshire,752,5960,3950,189,10099,2021,Sep
2021-09,New Jersey,0,8029,5452,599,14080,2021,Sep
2021-09,New Mexico,673,7152,4891,632,12675,2021,Sep
2021-09,New York,3507,9509,19378,2238,31125,2021,Sep
2021-09,North Carolina,31495,1589,15434,1274,18297,2021,Sep
2021-09,North Dakota,744,1873,3354,165,5392,2021,Sep
2021-09,Ohio,14950,21142,16111,1695,38948,2021,Sep
2021-09,Oklahoma,2280,11870,9528,1309,22707,2021,Sep
2021-09,Oregon,6953,15708,11018,0,26726,2021,Sep
2021-09,Pennsylvania,33224,44601,22537,34,67172,2021,Sep
2021-09,Puerto Rico,0,4770,332,53,5155,2021,Sep
2021-09,Rhode Island,0,1176,846,95,2117,2021,Sep
2021-09,South Carolina,12866,11082,7705,933,19720,2021,Sep
2021-09,South Dakota,911,2334,4012,228,6574,2021,Sep
2021-09,Tennessee,14921,27447,17916,1668,47031,2021,Sep
2021-09,Texas,24746,71702,41561,4300,117563,2021,Sep
2021-09,Utah,11111,5008,5004,509,10521,2021,Sep
2021-09,Vermont,0,1665,2027,120,3812,2021,Sep
2021-09,Virgin Islands,103,39,2,0,41,2021,Sep
2021-09,Virginia,240,23679,16736,3504,43919,2021,Sep
2021-09,Washington,17149,20879,14609,3222,38710,2021,Sep
2021-09,West Virginia,1777,5201,5922,322,11445,2021,Sep
2021-09,Wisconsin,27317,19515,16054,1209,36778,2021,Sep
2021-09,Wyoming,539,2161,2747,170,5078,2021,Sep
2021-08,Alabama,26984,18820,14786,1380,34986,2021,Aug
2021-08,Alaska,188,2847,3183,275,6305,2021,Aug
2021-08,Arizona,3236,18697,10195,1685,30577,2021,Aug
2021-08,Arkansas,3378,7146,6052,470,13668,2021,Aug
2021-08,California,17798,41275,28433,5995,75703,2021,Aug
2021-08,Colorado,9196,19708,13900,1582,35190,2021,Aug
2021-08,Connecticut,7695,6087,1841,886,8814,2021,Aug
2021-08,Delaware,475,2319,1679,167,4165,2021,Aug
2021-08,District of Columbia,685,336,4,0,340,2021,Aug
2021-08,Florida,22109,61168,24363,5238,90769,2021,Aug
2021-08,Georgia,24258,17598,9517,858,27973,2021,Aug
2021-08,Guam,0,260,113,25,398,2021,Aug
2021-08,Hawaii,1661,0,0,0,0,2021,Aug
2021-08,Idaho,5906,5986,6115,516,12617,2021,Aug
2021-08,Illinois,385196,26981,12930,1456,41367,2021,Aug
2021-08,Indiana,1800,21769,13831,1786,37386,2021,Aug
2021-08,Iowa,4586,2760,2670,96,5526,2021,Aug
2021-08,Kansas,2686,6215,5631,612,12458,2021,Aug
2021-08,Kentucky,875,10896,8616,587,20099,2021,Aug
2021-08,Louisiana,1799,12190,8107,930,21227,2021,Aug
2021-08,Maine,540,3684,4160,310,8154,2021,Aug
2021-08,Mariana Islands,0,14,11,2,27,2021,Aug
2021-08,Maryland,4067,8095,6372,157,14624,2021,Aug
2021-08,Massachusetts,9107,6392,3853,1045,11290,2021,Aug
2021-08,Michigan,18335,23032,17613,1962,42607,2021,Aug
2021-08,Minnesota,16237,12504,14381,1108,27993,2021,Aug
2021-08,Mississippi,2260,10370,8178,493,19041,2021,Aug
2021-08,Missouri,2773,19196,15047,1815,36058,2021,Aug
2021-08,Montana,1049,4047,4825,311,9183,2021,Aug
2021-08,Nebraska,4475,152,1815,32,1999,2021,Aug
2021-08,Nevada,4538,5971,2983,413,9367,2021,Aug
2021-08,New Hampshire,1157,5885,3454,139,9478,2021,Aug
2021-08,New Jersey,0,9533,5765,660,15958,2021,Aug
2021-08,New Mexico,876,7030,4726,586,12342,2021,Aug
2021-08,New York,3273,9863,16400,2109,28372,2021,Aug
2021-08,North Carolina,32676,1541,14143,1158,16842,2021,Aug
2021-08,North Dakota,900,1788,2977,144,4909,2021,Aug
2021-08,Ohio,16780,21249,15507,1483,38239,2021,Aug
2021-08,Oklahoma,2355,11608,9208,1196,22012,2021,Aug
2021-08,Oregon,6687,15867,10328,0,26195,2021,Aug
2021-08,Pennsylvania,32408,47491,21938,16,69445,2021,Aug
2021-08,Puerto Rico,0,4607,367,59,5033,2021,Aug
2021-08,Rhode Island,0,1189,740,62,1991,2021,Aug
2021-08,South Carolina,14052,11509,7043,779,19331,2021,Aug
2021-08,South Dakota,986,2347,3456,206,6009,2021,Aug
2021-08,Tennessee,16597,29364,18154,1745,49263,2021,Aug
2021-08,Texas,27475,64118,37508,3965,105591,2021,Aug
2021-08,Utah,11692,4844,4489,435,9768,2021,Aug
2021-08,Vermont,0,1751,1645,117,3513,2021,Aug
2021-08,Virgin Islands,88,26,5,0,31,2021,Aug
2021-08,Virginia,221,25669,15787,3516,44972,2021,Aug
2021-08,Washington,15363,19933,12733,2886,35552,2021,Aug
2021-08,West Virginia,2023,5145,5520,348,11013,2021,Aug
2021-08,Wisconsin,28106,19353,14271,1070,34694,2021,Aug
2021-08,Wyoming,575,2208,2442,160,4810,2021,Aug
2021-07,Alabama,27622,19797,12683,1507,33987,2021,Jul
2021-07,Alaska,263,2995,2571,309,5875,2021,Jul
2021-07,Arizona,4049,19751,9213,1836,30800,2021,Jul
2021-07,Arkansas,3563,7143,4681,472,12296,2021,Jul
2021-07,California,16911,41996,26036,5945,73977,2021,Jul
2021-07,Colorado,9905,19230,12186,1582,32998,2021,Jul
2021-07,Connecticut,8542,5337,1421,784,7542,2021,Jul
2021-07,Delaware,896,2322,1458,182,3962,2021,Jul
2021-07,District of Columbia,722,308,4,0,312,2021,Jul
2021-07,Florida,25724,62995,22918,5349,91262,2021,Jul
2021-07,Georgia,26260,18840,8330,918,28088,2021,Jul
2021-07,Guam,0,266,103,26,395,2021,Jul
2021-07,Hawaii,1133,0,0,0,0,2021,Jul
2021-07,Idaho,7453,5639,4885,536,11060,2021,Jul
2021-07,Illinois,357709,38557,15385,1605,55547,2021,Jul
2021-07,Indiana,1371,21274,11190,1668,34132,2021,Jul
2021-07,Iowa,4905,4092,2092,87,6271,2021,Jul
2021-07,Kansas,3230,6111,4473,591,11175,2021,Jul
2021-07,Kentucky,793,11047,7299,558,18904,2021,Jul
2021-07,Louisiana,4069,15119,6962,1038,23119,2021,Jul
2021-07,Maine,639,3851,3795,326,7972,2021,Jul
2021-07,Mariana Islands,0,10,12,2,24,2021,Jul
2021-07,Maryland,4337,8101,5770,101,13972,2021,Jul
2021-07,Massachusetts,9319,6476,3384,1202,11062,2021,Jul
2021-07,Michigan,17537,24053,14844,1998,40895,2021,Jul
2021-07,Minnesota,14849,11686,9964,1177,22827,2021,Jul
2021-07,Mississippi,2176,9899,5425,509,15833,2021,Jul
2021-07,Missouri,3734,20008,13122,1936,35066,2021,Jul
2021-07,Montana,974,3919,4022,271,8212,2021,Jul
2021-07,Nebraska,4351,169,1494,26,1689,2021,Jul
2021-07,Nevada,3959,5666,2580,427,8673,2021,Jul
2021-07,New Hampshire,916,5710,3525,165,9400,2021,Jul
2021-07,New Jersey,0,9720,5090,594,15404,2021,Jul
2021-07,New Mexico,913,7000,4250,659,11909,2021,Jul
2021-07,New York,3485,10045,14329,2186,26560,2021,Jul
2021-07,North Carolina,36869,1670,12991,1243,15904,2021,Jul
2021-07,North Dakota,1045,1722,2263,133,4118,2021,Jul
2021-07,Ohio,18183,22251,13383,1546,37180,2021,Jul
2021-07,Oklahoma,2674,12733,7926,1335,21994,2021,Jul
2021-07,Oregon,5664,15698,8712,0,24410,2021,Jul
2021-07,Pennsylvania,31780,46698,19944,28,66670,2021,Jul
2021-07,Puerto Rico,0,5074,348,57,5479,2021,Jul
2021-07,Rhode Island,0,1156,711,85,1952,2021,Jul
2021-07,South Carolina,13346,12041,6028,848,18917,2021,Jul
2021-07,South Dakota,1018,2333,2735,204,5272,2021,Jul
2021-07,Tennessee,37055,31906,15260,1650,48816,2021,Jul
2021-07,Texas,25470,65203,29692,4281,99176,2021,Jul
2021-07,Utah,10989,5015,3872,428,9315,2021,Jul
2021-07,Vermont,0,1836,1565,130,3531,2021,Jul
2021-07,Virgin Islands,129,61,3,1,65,2021,Jul
2021-07,Virginia,366,26346,14418,3568,44332,2021,Jul
2021-07,Washington,14277,19416,11471,3098,33985,2021,Jul
2021-07,West Virginia,2289,5300,5091,329,10720,2021,Jul
2021-07,Wisconsin,27661,18964,10888,1156,31008,2021,Jul
2021-07,Wyoming,842,2134,2126,159,4419,2021,Jul
2021-06,Alabama,31515,21625,13805,1448,36878,2021,Jun
2021-06,Alaska,299,2964,2388,279,5631,2021,Jun
2021-06,Arizona,5387,19608,8998,1809,30415,2021,Jun
2021-06,Arkansas,5959,7606,4729,450,12785,2021,Jun
2021-06,California,19320,42689,28180,7523,78392,2021,Jun
2021-06,Colorado,9963,19416,11932,1666,33014,2021,Jun
2021-06,Connecticut,15189,6971,1961,1205,10137,2021,Jun
2021-06,Delaware,564,2586,1319,208,4113,2021,Jun
2021-06,District of Columbia,649,309,10,0,319,2021,Jun
2021-06,Florida,26151,65835,23329,5551,94715,2021,Jun
2021-06,Georgia,26471,21732,8638,937,31307,2021,Jun
2021-06,Guam,0,232,122,27,381,2021,Jun
2021-06,Hawaii,1316,0,0,0,0,2021,Jun
2021-06,Idaho,6690,5730,4946,548,11224,2021,Jun
2021-06,Illinois,14242,24191,9377,0,33568,2021,Jun
2021-06,Indiana,899,21193,10780,1592,33565,2021,Jun
2021-06,Iowa,6022,174,1964,37,2175,2021,Jun
2021-06,Kansas,2448,6351,4578,588,11517,2021,Jun
2021-06,Kentucky,1026,11034,6804,510,18348,2021,Jun
2021-06,Louisiana,4275,16491,6995,1096,24582,2021,Jun
2021-06,Maine,551,3645,3143,331,7119,2021,Jun
2021-06,Mariana Islands,0,14,15,0,29,2021,Jun
2021-06,Maryland,5333,7909,5525,127,13561,2021,Jun
2021-06,Massachusetts,8095,6062,2966,1010,10038,2021,Jun
2021-06,Michigan,19090,24641,14734,2039,41414,2021,Jun
2021-06,Minnesota,15906,12119,9001,1021,22141,2021,Jun
2021-06,Mississippi,2367,10684,5523,565,16772,2021,Jun
2021-06,Missouri,4514,20234,12466,1890,34590,2021,Jun
2021-06,Montana,1072,3972,3918,268,8158,2021,Jun
2021-06,Nebraska,3728,146,1381,26,1553,2021,Jun
2021-06,Nevada,3813,6128,2676,451,9255,2021,Jun
2021-06,New Hampshire,952,5409,2986,132,8527,2021,Jun
2021-06,New Jersey,0,11220,5370,752,17342,2021,Jun
2021-06,New Mexico,948,6867,4181,657,11705,2021,Jun
2021-06,New York,3754,10062,13400,2261,25723,2021,Jun
2021-06,North Carolina,40234,1673,12788,1269,15730,2021,Jun
2021-06,North Dakota,1004,1721,2227,149,4097,2021,Jun
2021-06,Ohio,20686,23534,12963,1335,37832,2021,Jun
2021-06,Oklahoma,2922,12794,7442,1285,21521,2021,Jun
2021-06,Oregon,7024,15593,9235,0,24828,2021,Jun
2021-06,Pennsylvania,33431,46571,19100,29,65700,2021,Jun
2021-06,Puerto Rico,0,5527,359,81,5967,2021,Jun
2021-06,Rhode Island,0,1160,729,66,1955,2021,Jun
2021-06,South Carolina,13470,13662,6023,851,20536,2021,Jun
2021-06,South Dakota,754,2222,2454,179,4855,2021,Jun
2021-06,Tennessee,60775,30015,14389,1712,46116,2021,Jun
2021-06,Texas,30745,71295,30634,4550,106479,2021,Jun
2021-06,Utah,14801,4761,3695,444,8900,2021,Jun
2021-06,Vermont,0,1669,1377,138,3184,2021,Jun
2021-06,Virgin Islands,252,52,8,0,60,2021,Jun
2021-06,Virginia,1060,26685,14348,3645,44678,2021,Jun
2021-06,Washington,14830,20813,11547,3137,35497,2021,Jun
2021-06,West Virginia,2213,4876,4355,290,9521,2021,Jun
2021-06,Wisconsin,29341,17881,10460,992,29333,2021,Jun
2021-06,Wyoming,1203,2071,2057,156,4284,2021,Jun
2021-05,Alabama,28248,21664,12423,1334,35421,2021,May
2021-05,Alaska,307,3368,2701,323,6392,2021,May
2021-05,Arizona,21767,20984,9259,1676,31919,2021,May
2021-05,Arkansas,7697,8501,5072,422,13995,2021,May
2021-05,California,20742,40160,25824,5576,71560,2021,May
2021-05,Colorado,11105,21819,12848,1987,36654,2021,May
2021-05,Connecticut,19608,7935,2012,1288,11235,2021,May
2021-05,Delaware,438,3096,1325,172,4593,2021,May
2021-05,District of Columbia,393,354,11,0,365,2021,May
2021-05,Florida,32677,65295,22922,4934,93151,2021,May
2021-05,Georgia,25474,23243,8801,873,32917,2021,May
2021-05,Guam,0,232,105,25,362,2021,May
2021-05,Hawaii,1163,0,0,0,0,2021,May
2021-05,Idaho,5614,6539,5208,544,12291,2021,May
2021-05,Illinois,16682,25210,9855,0,35065,2021,May
2021-05,Indiana,1099,22724,11629,1660,36013,2021,May
2021-05,Iowa,6436,199,2290,35,2524,2021,May
2021-05,Kansas,1858,7043,4971,736,12750,2021,May
2021-05,Kentucky,1423,11863,7497,520,19880,2021,May
2021-05,Louisiana,3164,16067,7157,1065,24289,2021,May
2021-05,Maine,571,3756,3362,309,7427,2021,May
2021-05,Mariana Islands,0,11,8,2,21,2021,May
2021-05,Maryland,6240,8497,5810,146,14453,2021,May
2021-05,Massachusetts,9501,5803,2840,1161,9804,2021,May
2021-05,Michigan,20648,26243,15258,2004,43505,2021,May
2021-05,Minnesota,18548,13713,9921,1244,24878,2021,May
2021-05,Mississippi,2465,11779,5751,516,18046,2021,May
2021-05,Missouri,5136,22598,14505,1992,39095,2021,May
2021-05,Montana,1323,4614,4411,336,9361,2021,May
2021-05,Nebraska,4317,172,1472,29,1673,2021,May
2021-05,Nevada,4070,7215,2999,480,10694,2021,May
2021-05,New Hampshire,1245,6182,3210,142,9534,2021,May
2021-05,New Jersey,0,13096,5789,828,19713,2021,May
2021-05,New Mexico,952,7437,4429,662,12528,2021,May
2021-05,New York,3945,10643,14212,2401,27256,2021,May
2021-05,North Carolina,39022,1739,13357,1283,16379,2021,May
2021-05,North Dakota,527,2155,2484,150,4789,2021,May
2021-05,Ohio,20247,26043,13075,1345,40463,2021,May
2021-05,Oklahoma,3407,13674,8126,1336,23136,2021,May
2021-05,Oregon,7808,16748,9555,0,26303,2021,May
2021-05,Pennsylvania,33626,48158,19442,32,67632,2021,May
2021-05,Puerto Rico,0,5621,390,84,6095,2021,May
2021-05,Rhode Island,0,1235,709,80,2024,2021,May
2021-05,South Carolina,14550,14208,5776,775,20759,2021,May
2021-05,South Dakota,1024,2718,2865,281,5864,2021,May
2021-05,Tennessee,11159,31082,14602,1634,47318,2021,May
2021-05,Texas,39607,72175,32613,4744,109532,2021,May
2021-05,Utah,16939,5747,4115,472,10334,2021,May
2021-05,Vermont,0,1805,1473,125,3403,2021,May
2021-05,Virgin Islands,70,44,3,0,47,2021,May
2021-05,Virginia,1620,26658,13588,3489,43735,2021,May
2021-05,Washington,17148,21429,11338,3371,36138,2021,May
2021-05,West Virginia,2434,5425,4682,271,10378,2021,May
2021-05,Wisconsin,26556,20008,11321,1141,32470,2021,May
2021-05,Wyoming,1022,2587,2200,207,4994,2021,May
2021-04,Alabama,35936,28723,16905,1962,47590,2021,Apr
2021-04,Alaska,143,4156,3687,533,8376,2021,Apr
2021-04,Arizona,9798,27833,12248,2326,42407,2021,Apr
2021-04,Arkansas,5039,10942,7366,600,18908,2021,Apr
2021-04,California,17570,44095,30019,7117,81231,2021,Apr
2021-04,Colorado,12220,27130,16132,2436,45698,2021,Apr
2021-04,Connecticut,20318,8229,2214,1915,12358,2021,Apr
2021-04,Delaware,511,4546,1797,248,6591,2021,Apr
2021-04,District of Columbia,651,367,5,0,372,2021,Apr
2021-04,Florida,37324,79583,30218,6345,116146,2021,Apr
2021-04,Georgia,33271,29441,11605,1256,42302,2021,Apr
2021-04,Guam,0,227,88,34,349,2021,Apr
2021-04,Hawaii,1354,0,0,0,0,2021,Apr
2021-04,Idaho,9272,8381,6644,892,15917,2021,Apr
2021-04,Illinois,21918,30084,12523,0,42607,2021,Apr
2021-04,Indiana,1188,29792,16385,2400,48577,2021,Apr
2021-04,Iowa,10970,283,2900,66,3249,2021,Apr
2021-04,Kansas,2656,9185,6492,890,16567,2021,Apr
2021-04,Kentucky,1448,16555,11347,742,28644,2021,Apr
2021-04,Louisiana,4138,19881,9348,1424,30653,2021,Apr
2021-04,Maine,690,5376,4476,558,10410,2021,Apr
2021-04,Mariana Islands,0,9,7,1,17,2021,Apr
2021-04,Maryland,7203,10753,7293,143,18189,2021,Apr
2021-04,Massachusetts,9288,8008,3811,1417,13236,2021,Apr
2021-04,Michigan,24972,34820,20687,2997,58504,2021,Apr
2021-04,Minnesota,27848,19432,13989,1807,35228,2021,Apr
2021-04,Mississippi,3434,16031,7950,839,24820,2021,Apr
2021-04,Missouri,6523,26961,18774,2755,48490,2021,Apr
2021-04,Montana,1975,5848,5544,448,11840,2021,Apr
2021-04,Nebraska,6340,248,1993,44,2285,2021,Apr
2021-04,Nevada,4746,8677,3658,619,12954,2021,Apr
2021-04,New Hampshire,1657,8099,4548,139,12786,2021,Apr
2021-04,New Jersey,0,15954,7827,1058,24839,2021,Apr
2021-04,New Mexico,1073,9826,6315,852,16993,2021,Apr
2021-04,New York,4452,12170,18513,3304,33987,2021,Apr
2021-04,North Carolina,50010,1936,17807,1642,21385,2021,Apr
2021-04,North Dakota,570,2998,3434,240,6672,2021,Apr
2021-04,Ohio,24166,34710,18884,1928,55522,2021,Apr
2021-04,Oklahoma,3648,17709,10919,2298,30926,2021,Apr
2021-04,Oregon,8135,20560,11400,0,31960,2021,Apr
2021-04,Pennsylvania,43186,62389,25486,39,87914,2021,Apr
2021-04,Puerto Rico,0,5206,354,80,5640,2021,Apr
2021-04,Rhode Island,0,1722,1040,150,2912,2021,Apr
2021-04,South Carolina,15041,17866,7696,1061,26623,2021,Apr
2021-04,South Dakota,1147,3826,3701,335,7862,2021,Apr
2021-04,Tennessee,11845,39652,19833,2036,61521,2021,Apr
2021-04,Texas,51375,79802,39265,5959,125026,2021,Apr
2021-04,Utah,18756,7585,5343,623,13551,2021,Apr
2021-04,Vermont,1,2313,2279,243,4835,2021,Apr
2021-04,Virgin Islands,123,44,3,0,47,2021,Apr
2021-04,Virginia,1405,34633,17980,4395,57008,2021,Apr
2021-04,Washington,17277,28469,14987,4445,47901,2021,Apr
2021-04,West Virginia,3394,7787,6748,466,15001,2021,Apr
2021-04,Wisconsin,26024,27652,15672,1661,44985,2021,Apr
2021-04,Wyoming,511,3443,3105,296,6844,2021,Apr
2021-03,Alabama,42992,34675,20702,2048,57425,2021,Mar
2021-03,Alaska,322,4375,4186,590,9151,2021,Mar
2021-03,Arizona,10118,32738,15268,2497,50503,2021,Mar
2021-03,Arkansas,3712,15039,9815,723,25577,2021,Mar
2021-03,California,17904,50271,35334,7327,92932,2021,Mar
2021-03,Colorado,13329,31050,19529,2771,53350,2021,Mar
2021-03,Connecticut,13856,8811,2590,2221,13622,2021,Mar
2021-03,Delaware,565,3994,2056,226,6276,2021,Mar
2021-03,District of Columbia,576,409,5,0,414,2021,Mar
2021-03,Florida,34498,91131,33936,6429,131496,2021,Mar
2021-03,Georgia,38669,36123,14431,1313,51867,2021,Mar
2021-03,Guam,0,270,108,16,394,2021,Mar
2021-03,Hawaii,1763,0,0,0,0,2021,Mar
2021-03,Idaho,13096,10546,8550,951,20047,2021,Mar
2021-03,Illinois,23382,35699,16114,0,51813,2021,Mar
2021-03,Indiana,912,36403,19692,2543,58638,2021,Mar
2021-03,Iowa,17828,314,3905,72,4291,2021,Mar
2021-03,Kansas,2502,12516,8543,1107,22166,2021,Mar
2021-03,Kentucky,1802,21777,14505,911,37193,2021,Mar
2021-03,Louisiana,5928,24021,11351,1624,36996,2021,Mar
2021-03,Maine,994,6795,5590,577,12962,2021,Mar
2021-03,Mariana Islands,0,18,7,3,28,2021,Mar
2021-03,Maryland,9445,12103,8531,183,20817,2021,Mar
2021-03,Massachusetts,13304,8683,4150,1633,14466,2021,Mar
2021-03,Michigan,30447,41979,24546,3411,69936,2021,Mar
2021-03,Minnesota,30197,21643,16144,1881,39668,2021,Mar
2021-03,Mississippi,3558,19386,10388,870,30644,2021,Mar
2021-03,Missouri,8226,36589,24048,3145,63782,2021,Mar
2021-03,Montana,2023,7144,6774,527,14445,2021,Mar
2021-03,Nebraska,7654,282,2667,33,2982,2021,Mar
2021-03,Nevada,5894,9310,3953,526,13789,2021,Mar
2021-03,New Hampshire,1694,9949,5075,243,15267,2021,Mar
2021-03,New Jersey,0,15643,7663,1025,24331,2021,Mar
2021-03,New Mexico,1081,11694,7378,997,20069,2021,Mar
2021-03,New York,4955,14211,21691,3916,39818,2021,Mar
2021-03,North Carolina,57556,2461,22751,1857,27069,2021,Mar
2021-03,North Dakota,801,3640,4061,259,7960,2021,Mar
2021-03,Ohio,25646,42665,23081,2175,67921,2021,Mar
2021-03,Oklahoma,4194,22079,13712,2194,37985,2021,Mar
2021-03,Oregon,10308,23731,13927,0,37658,2021,Mar
2021-03,Pennsylvania,47252,74896,30420,49,105365,2021,Mar
2021-03,Puerto Rico,0,4296,271,72,4639,2021,Mar
2021-03,Rhode Island,0,2231,1389,154,3774,2021,Mar
2021-03,South Carolina,17815,23615,10083,1146,34844,2021,Mar
2021-03,South Dakota,1151,5016,5071,381,10468,2021,Mar
2021-03,Tennessee,12979,46941,25205,2628,74774,2021,Mar
2021-03,Texas,53947,95320,47817,6098,149235,2021,Mar
2021-03,Utah,21021,9765,6818,739,17322,2021,Mar
2021-03,Vermont,0,2967,2511,215,5693,2021,Mar
2021-03,Virgin Islands,146,51,6,1,58,2021,Mar
2021-03,Virginia,1228,42816,22192,5093,70101,2021,Mar
2021-03,Washington,20324,29172,16595,4807,50574,2021,Mar
2021-03,West Virginia,4201,10610,9063,500,20173,2021,Mar
2021-03,Wisconsin,21114,33440,18939,1894,54273,2021,Mar
2021-03,Wyoming,700,4004,3635,260,7899,2021,Mar
2021-02,Alabama,31803,20970,16026,1548,38544,2021,Feb
2021-02,Alaska,222,3055,2564,375,5994,2021,Feb
2021-02,Arizona,9290,20530,9991,1754,32275,2021,Feb
2021-02,Arkansas,3123,7068,5289,448,12805,2021,Feb
2021-02,California,16025,40789,27915,6499,75203,2021,Feb
2021-02,Colorado,10891,21729,13839,1960,37528,2021,Feb
2021-02,Connecticut,9792,6046,1996,1438,9480,2021,Feb
2021-02,Delaware,353,2775,1563,158,4496,2021,Feb
2021-02,District of Columbia,538,304,4,0,308,2021,Feb
2021-02,Florida,31875,66307,26720,5116,98143,2021,Feb
2021-02,Georgia,37243,21523,10215,1122,32860,2021,Feb
2021-02,Guam,0,190,70,34,294,2021,Feb
2021-02,Hawaii,1504,0,0,0,0,2021,Feb
2021-02,Idaho,6846,6973,5631,762,13366,2021,Feb
2021-02,Illinois,18820,24290,11338,0,35628,2021,Feb
2021-02,Indiana,902,25161,14378,2063,41602,2021,Feb
2021-02,Iowa,15966,204,2462,65,2731,2021,Feb
2021-02,Kansas,2083,7573,5810,865,14248,2021,Feb
2021-02,Kentucky,1304,12171,8806,609,21586,2021,Feb
2021-02,Louisiana,2435,13373,7560,1094,22027,2021,Feb
2021-02,Maine,678,4167,3357,416,7940,2021,Feb
2021-02,Mariana Islands,0,10,2,3,15,2021,Feb
2021-02,Maryland,7561,9199,6777,136,16112,2021,Feb
2021-02,Massachusetts,11858,6856,3385,1181,11422,2021,Feb
2021-02,Michigan,21953,28567,17556,2545,48668,2021,Feb
2021-02,Minnesota,23639,15446,10501,1380,27327,2021,Feb
2021-02,Mississippi,2468,9386,6389,573,16348,2021,Feb
2021-02,Missouri,5368,21819,16008,2157,39984,2021,Feb
2021-02,Montana,2254,4301,3920,408,8629,2021,Feb
2021-02,Nebraska,5639,236,1739,36,2011,2021,Feb
2021-02,Nevada,3965,6884,3079,473,10436,2021,Feb
2021-02,New Hampshire,1550,7071,3428,248,10747,2021,Feb
2021-02,New Jersey,0,12782,6457,806,20045,2021,Feb
2021-02,New Mexico,1017,7799,4700,658,13157,2021,Feb
2021-02,New York,3746,10259,15690,3263,29212,2021,Feb
2021-02,North Carolina,49450,2128,15798,1387,19313,2021,Feb
2021-02,North Dakota,673,2353,2572,206,5131,2021,Feb
2021-02,Ohio,18462,28134,16727,1730,46591,2021,Feb
2021-02,Oklahoma,2501,12984,8793,1467,23244,2021,Feb
2021-02,Oregon,7123,16296,9940,0,26236,2021,Feb
2021-02,Pennsylvania,36118,54737,22421,40,77198,2021,Feb
2021-02,Puerto Rico,0,3411,231,54,3696,2021,Feb
2021-02,Rhode Island,0,1889,1034,151,3074,2021,Feb
2021-02,South Carolina,13811,15041,7521,910,23472,2021,Feb
2021-02,South Dakota,757,3654,3939,375,7968,2021,Feb
2021-02,Tennessee,9436,29633,17566,1760,48959,2021,Feb
2021-02,Texas,38182,53772,27829,4217,85818,2021,Feb
2021-02,Utah,19487,6423,4559,538,11520,2021,Feb
2021-02,Vermont,0,1965,1571,179,3715,2021,Feb
2021-02,Virgin Islands,107,48,4,0,52,2021,Feb
2021-02,Virginia,1935,29404,16798,3930,50132,2021,Feb
2021-02,Washington,17955,24100,12681,3761,40542,2021,Feb
2021-02,West Virginia,3153,6478,6160,347,12985,2021,Feb
2021-02,Wisconsin,16585,20757,12376,1180,34313,2021,Feb
2021-02,Wyoming,682,2724,2320,226,5270,2021,Feb
2021-01,Alabama,39955,33563,23477,2309,59349,2021,Jan
2021-01,Alaska,283,3989,3574,563,8126,2021,Jan
2021-01,Arizona,9237,29336,14430,2339,46105,2021,Jan
2021-01,Arkansas,3231,11993,10043,715,22751,2021,Jan
2021-01,California,19078,55103,36179,6807,98089,2021,Jan
2021-01,Colorado,10179,30172,18855,2702,51729,2021,Jan
2021-01,Connecticut,10880,8832,3192,2220,14244,2021,Jan
2021-01,Delaware,53,4275,2391,234,6900,2021,Jan
2021-01,District of Columbia,693,357,8,0,365,2021,Jan
2021-01,Florida,34470,97406,40173,6686,144265,2021,Jan
2021-01,Georgia,36667,33178,16797,1596,51571,2021,Jan
2021-01,Guam,0,161,84,45,290,2021,Jan
2021-01,Hawaii,1503,0,0,0,0,2021,Jan
2021-01,Idaho,6150,11036,8507,1045,20588,2021,Jan
2021-01,Illinois,34093,35848,17817,0,53665,2021,Jan
2021-01,Indiana,1205,37237,22732,3005,62974,2021,Jan
2021-01,Iowa,21062,304,4155,98,4557,2021,Jan
2021-01,Kansas,1566,12023,9512,1180,22715,2021,Jan
2021-01,Kentucky,1562,20728,15271,982,36981,2021,Jan
2021-01,Louisiana,2758,19621,13155,1534,34310,2021,Jan
2021-01,Maine,678,6644,5230,582,12456,2021,Jan
2021-01,Mariana Islands,0,13,9,0,22,2021,Jan
2021-01,Maryland,7515,12312,10732,137,23181,2021,Jan
2021-01,Massachusetts,12398,9873,5021,1676,16570,2021,Jan
2021-01,Michigan,30312,44266,28699,3878,76843,2021,Jan
2021-01,Minnesota,26909,20206,14259,1803,36268,2021,Jan
2021-01,Mississippi,3264,15048,11420,847,27315,2021,Jan
2021-01,Missouri,5526,34178,24308,3423,61909,2021,Jan
2021-01,Montana,3227,6523,6292,561,13376,2021,Jan
2021-01,Nebraska,6956,340,2947,58,3345,2021,Jan
2021-01,Nevada,3829,9181,4325,529,14035,2021,Jan
2021-01,New Hampshire,1740,11034,5624,465,17123,2021,Jan
2021-01,New Jersey,0,17347,9596,1020,27963,2021,Jan
2021-01,New Mexico,994,9617,6511,870,16998,2021,Jan
2021-01,New York,3664,12143,25221,4447,41811,2021,Jan
2021-01,North Carolina,51156,2814,25266,1994,30074,2021,Jan
2021-01,North Dakota,443,3664,3854,261,7779,2021,Jan
2021-01,Ohio,19539,45379,26775,2405,74559,2021,Jan
2021-01,Oklahoma,3084,21729,15182,2581,39492,2021,Jan
2021-01,Oregon,8849,24459,14997,0,39456,2021,Jan
2021-01,Pennsylvania,44600,81592,32671,41,114304,2021,Jan
2021-01,Puerto Rico,0,3463,258,72,3793,2021,Jan
2021-01,Rhode Island,0,2279,1421,188,3888,2021,Jan
2021-01,South Carolina,16989,20417,11129,1278,32824,2021,Jan
2021-01,South Dakota,989,5326,5011,530,10867,2021,Jan
2021-01,Tennessee,10595,46194,29203,2727,78124,2021,Jan
2021-01,Texas,58691,84022,47149,6067,137238,2021,Jan
2021-01,Utah,20909,9840,6964,746,17550,2021,Jan
2021-01,Vermont,0,3005,2523,236,5764,2021,Jan
2021-01,Virgin Islands,90,58,5,0,63,2021,Jan
2021-01,Virginia,1007,41711,23650,5208,70569,2021,Jan
2021-01,Washington,17599,30106,17179,4843,52128,2021,Jan
2021-01,West Virginia,3404,10142,9708,565,20415,2021,Jan
2021-01,Wisconsin,23800,30495,16304,1797,48596,2021,Jan
2021-01,Wyoming,654,4039,3697,338,8074,2021,Jan
2020-12,Alabama,33421,31103,28933,1855,61891,2020,Dec
2020-12,Alaska,441,3658,3822,430,7910,2020,Dec
2020-12,Arizona,9043,25093,14562,1942,41597,2020,Dec
2020-12,Arkansas,3878,10987,12719,587,24293,2020,Dec
2020-12,California,26034,59909,39389,6932,106230,2020,Dec
2020-12,Colorado,10201,25577,19716,2132,47425,2020,Dec
2020-12,Connecticut,9783,6741,2694,1682,11117,2020,Dec
2020-12,Delaware,201,3281,2610,200,6091,2020,Dec
2020-12,District of Columbia,760,322,17,0,339,2020,Dec
2020-12,Florida,35227,81564,40115,5594,127273,2020,Dec
2020-12,Georgia,32767,28405,20236,1326,49967,2020,Dec
2020-12,Guam,0,182,71,22,275,2020,Dec
2020-12,Hawaii,2003,0,0,0,0,2020,Dec
2020-12,Idaho,6675,9354,9550,809,19713,2020,Dec
2020-12,Illinois,20056,29133,16557,0,45690,2020,Dec
2020-12,Indiana,1082,30336,21852,2192,54380,2020,Dec
2020-12,Iowa,16368,312,4678,70,5060,2020,Dec
2020-12,Kansas,1799,9708,9941,893,20542,2020,Dec
2020-12,Kentucky,1365,19170,17438,765,37373,2020,Dec
2020-12,Louisiana,2726,19311,18379,1465,39155,2020,Dec
2020-12,Maine,470,5001,5320,434,10755,2020,Dec
2020-12,Mariana Islands,0,13,11,5,29,2020,Dec
2020-12,Maryland,8693,10338,9565,407,20310,2020,Dec
2020-12,Massachusetts,11182,7790,3882,1067,12739,2020,Dec
2020-12,Michigan,20363,33647,29180,3121,65948,2020,Dec
2020-12,Minnesota,25217,15976,14943,1658,32577,2020,Dec
2020-12,Mississippi,2844,14651,16554,709,31914,2020,Dec
2020-12,Missouri,4306,29358,26348,2683,58389,2020,Dec
2020-12,Montana,2295,5858,7265,405,13528,2020,Dec
2020-12,Nebraska,6766,297,3662,39,3998,2020,Dec
2020-12,Nevada,2780,8205,4599,481,13285,2020,Dec
2020-12,New Hampshire,1585,7660,4811,285,12756,2020,Dec
2020-12,New Jersey,0,12667,7473,794,20934,2020,Dec
2020-12,New Mexico,1407,8979,6931,752,16662,2020,Dec
2020-12,New York,3261,10486,24664,3145,38295,2020,Dec
2020-12,North Carolina,45294,2647,28052,1607,32306,2020,Dec
2020-12,North Dakota,706,2784,4076,217,7077,2020,Dec
2020-12,Ohio,19242,33723,27057,1804,62584,2020,Dec
2020-12,Oklahoma,2377,18791,17433,2045,38269,2020,Dec
2020-12,Oregon,7579,21533,16161,0,37694,2020,Dec
2020-12,Pennsylvania,33608,62948,29262,41,92251,2020,Dec
2020-12,Puerto Rico,0,3569,241,72,3882,2020,Dec
2020-12,Rhode Island,0,1794,1081,110,2985,2020,Dec
2020-12,South Carolina,14529,17908,13367,1011,32286,2020,Dec
2020-12,South Dakota,782,4259,5814,382,10455,2020,Dec
2020-12,Tennessee,10324,40019,32201,2195,74415,2020,Dec
2020-12,Texas,48860,79774,58650,5211,143635,2020,Dec
2020-12,Utah,18413,9296,9136,695,19127,2020,Dec
2020-12,Vermont,0,2351,2413,174,4938,2020,Dec
2020-12,Virgin Islands,162,44,3,1,48,2020,Dec
2020-12,Virginia,1149,36502,26668,4634,67804,2020,Dec
2020-12,Washington,20536,27422,18368,4047,49837,2020,Dec
2020-12,West Virginia,2471,8706,10939,412,20057,2020,Dec
2020-12,Wisconsin,17883,23321,17480,1537,42338,2020,Dec
2020-12,Wyoming,904,3998,4137,280,8415,2020,Dec
2020-11,Alabama,30694,27765,25924,1931,55620,2020,Nov
2020-11,Alaska,96,3474,3878,461,7813,2020,Nov
2020-11,Arizona,7483,25906,14698,2157,42761,2020,Nov
2020-11,Arkansas,4096,10069,12954,599,23622,2020,Nov
2020-11,California,28797,56793,37256,7391,101440,2020,Nov
2020-11,Colorado,8841,27091,20410,2421,49922,2020,Nov
2020-11,Connecticut,8786,7253,2986,2115,12354,2020,Nov
2020-11,Delaware,320,3863,2777,198,6838,2020,Nov
2020-11,District of Columbia,691,332,11,0,343,2020,Nov
2020-11,Florida,35979,84366,40575,6090,131031,2020,Nov
2020-11,Georgia,28389,28102,19042,1358,48502,2020,Nov
2020-11,Guam,0,205,99,32,336,2020,Nov
2020-11,Hawaii,1720,0,0,0,0,2020,Nov
2020-11,Idaho,5266,8946,9372,892,19210,2020,Nov
2020-11,Illinois,27657,29335,17557,0,46892,2020,Nov
2020-11,Indiana,1089,29416,24425,2231,56072,2020,Nov
2020-11,Iowa,12125,365,5751,84,6200,2020,Nov
2020-11,Kansas,1205,10569,10435,981,21985,2020,Nov
2020-11,Kentucky,1608,16578,17091,806,34475,2020,Nov
2020-11,Louisiana,2493,17819,18448,1507,37774,2020,Nov
2020-11,Maine,528,4801,6062,436,11299,2020,Nov
2020-11,Mariana Islands,0,10,3,0,13,2020,Nov
2020-11,Maryland,8416,10864,11038,764,22666,2020,Nov
2020-11,Massachusetts,12361,8817,4397,1216,14430,2020,Nov
2020-11,Michigan,22609,35190,35065,2866,73121,2020,Nov
2020-11,Minnesota,25000,16316,17448,1506,35270,2020,Nov
2020-11,Mississippi,2572,12893,15003,757,28653,2020,Nov
2020-11,Missouri,3187,27413,27727,2932,58072,2020,Nov
2020-11,Montana,2075,5060,6609,418,12087,2020,Nov
2020-11,Nebraska,6102,380,4117,45,4542,2020,Nov
2020-11,Nevada,2997,9055,4507,548,14110,2020,Nov
2020-11,New Hampshire,2001,9055,5356,248,14659,2020,Nov
2020-11,New Jersey,0,13826,8053,869,22748,2020,Nov
2020-11,New Mexico,1123,7277,5495,715,13487,2020,Nov
2020-11,New York,3203,10393,28951,3768,43112,2020,Nov
2020-11,North Carolina,45847,2770,28807,1852,33429,2020,Nov
2020-11,North Dakota,434,2738,4153,211,7102,2020,Nov
2020-11,Ohio,17994,37382,32959,2122,72463,2020,Nov
2020-11,Oklahoma,2172,18163,16961,1890,37014,2020,Nov
2020-11,Oregon,6347,21990,15648,0,37638,2020,Nov
2020-11,Pennsylvania,38174,75428,34686,29,110143,2020,Nov
2020-11,Puerto Rico,0,2883,217,60,3160,2020,Nov
2020-11,Rhode Island,0,2033,1419,158,3610,2020,Nov
2020-11,South Carolina,13819,19010,13569,1136,33715,2020,Nov
2020-11,South Dakota,728,4302,6560,362,11224,2020,Nov
2020-11,Tennessee,10897,37467,31625,2298,71390,2020,Nov
2020-11,Texas,43661,78827,56265,5504,140596,2020,Nov
2020-11,Utah,19297,9582,9044,764,19390,2020,Nov
2020-11,Vermont,0,2104,2445,217,4766,2020,Nov
2020-11,Virgin Islands,176,37,4,0,41,2020,Nov
2020-11,Virginia,616,35909,26638,4874,67421,2020,Nov
2020-11,Washington,18905,27563,18592,4350,50505,2020,Nov
2020-11,West Virginia,2486,8086,11767,483,20336,2020,Nov
2020-11,Wisconsin,20980,25742,21825,1596,49163,2020,Nov
2020-11,Wyoming,768,3685,4452,308,8445,2020,Nov
2020-10,Alabama,32038,24084,17964,1698,43746,2020,Oct
2020-10,Alaska,264,3209,3210,348,6767,2020,Oct
2020-10,Arizona,8991,24964,12288,1951,39203,2020,Oct
2020-10,Arkansas,5108,8931,9386,567,18884,2020,Oct
2020-10,California,36719,65376,40286,8319,113981,2020,Oct
2020-10,Colorado,11161,25802,17699,2102,45603,2020,Oct
2020-10,Connecticut,9785,6821,2764,1785,11370,2020,Oct
2020-10,Delaware,437,3951,2489,188,6628,2020,Oct
2020-10,District of Columbia,1004,470,11,0,481,2020,Oct
2020-10,Florida,43802,83816,32346,5782,121944,2020,Oct
2020-10,Georgia,31924,26383,14710,1145,42238,2020,Oct
2020-10,Guam,0,221,88,32,341,2020,Oct
2020-10,Hawaii,2110,0,0,0,0,2020,Oct
2020-10,Idaho,6684,7439,8153,613,16205,2020,Oct
2020-10,Illinois,27352,28277,14905,0,43182,2020,Oct
2020-10,Indiana,1186,27979,18181,2216,48376,2020,Oct
2020-10,Iowa,10952,218,4151,50,4419,2020,Oct
2020-10,Kansas,949,8659,7551,814,17024,2020,Oct
2020-10,Kentucky,1912,15816,12804,763,29383,2020,Oct
2020-10,Louisiana,2935,15180,13153,1312,29645,2020,Oct
2020-10,Maine,663,5087,8215,375,13677,2020,Oct
2020-10,Mariana Islands,0,15,12,1,28,2020,Oct
2020-10,Maryland,12233,10843,9873,159,20875,2020,Oct
2020-10,Massachusetts,13309,8354,4364,1112,13830,2020,Oct
2020-10,Michigan,30855,34940,28266,2745,65951,2020,Oct
2020-10,Minnesota,30213,16941,20404,1317,38662,2020,Oct
2020-10,Mississippi,3173,10982,10229,655,21866,2020,Oct
2020-10,Missouri,4294,25340,22636,2386,50362,2020,Oct
2020-10,Montana,2158,4429,7087,374,11890,2020,Oct
2020-10,Nebraska,5648,234,2960,30,3224,2020,Oct
2020-10,Nevada,4677,8764,3693,496,12953,2020,Oct
2020-10,New Hampshire,1919,7906,5243,177,13326,2020,Oct
2020-10,New Jersey,0,13275,7171,851,21297,2020,Oct
2020-10,New Mexico,1708,7814,5189,674,13677,2020,Oct
2020-10,New York,4243,10541,28281,3588,42410,2020,Oct
2020-10,North Carolina,51717,2421,21403,1663,25487,2020,Oct
2020-10,North Dakota,638,2326,4589,158,7073,2020,Oct
2020-10,Ohio,21228,35332,23048,1962,60342,2020,Oct
2020-10,Oklahoma,2401,14860,11904,1513,28277,2020,Oct
2020-10,Oregon,6760,22277,14255,0,36532,2020,Oct
2020-10,Pennsylvania,41227,73607,29581,45,103233,2020,Oct
2020-10,Puerto Rico,0,3714,252,65,4031,2020,Oct
2020-10,Rhode Island,0,2143,1359,143,3645,2020,Oct
2020-10,South Carolina,15855,17032,10168,1035,28235,2020,Oct
2020-10,South Dakota,847,3537,6336,243,10116,2020,Oct
2020-10,Tennessee,13850,33275,22568,1973,57816,2020,Oct
2020-10,Texas,57784,72591,44620,5042,122253,2020,Oct
2020-10,Utah,19408,7356,6378,590,14324,2020,Oct
2020-10,Vermont,0,2139,2723,176,5038,2020,Oct
2020-10,Virgin Islands,71,37,4,0,41,2020,Oct
2020-10,Virginia,1082,37867,22986,4606,65459,2020,Oct
2020-10,Washington,20254,26765,17191,4170,48126,2020,Oct
2020-10,West Virginia,3080,6934,8559,398,15891,2020,Oct
2020-10,Wisconsin,23899,26028,19720,1353,47101,2020,Oct
2020-10,Wyoming,955,2616,3207,210,6033,2020,Oct
2020-09,Alabama,33228,23455,17369,1633,42457,2020,Sep
2020-09,Alaska,388,3275,3333,345,6953,2020,Sep
2020-09,Arizona,8786,23996,12094,1963,38053,2020,Sep
2020-09,Arkansas,3686,9214,8003,505,17722,2020,Sep
2020-09,California,32998,61258,36638,7815,105711,2020,Sep
2020-09,Colorado,10309,24260,15873,1919,42052,2020,Sep
2020-09,Connecticut,9845,6101,2284,1443,9828,2020,Sep
2020-09,Delaware,470,3501,1909,176,5586,2020,Sep
2020-09,District of Columbia,901,531,11,0,542,2020,Sep
2020-09,Florida,34496,76685,29317,5523,111525,2020,Sep
2020-09,Georgia,30356,24175,12797,1112,38084,2020,Sep
2020-09,Guam,0,150,54,35,239,2020,Sep
2020-09,Hawaii,1534,0,0,0,0,2020,Sep
2020-09,Idaho,6034,7297,7426,629,15352,2020,Sep
2020-09,Illinois,33632,27645,13848,0,41493,2020,Sep
2020-09,Indiana,1254,26530,15978,1955,44463,2020,Sep
2020-09,Iowa,9649,227,3541,56,3824,2020,Sep
2020-09,Kansas,1382,7897,6489,662,15048,2020,Sep
2020-09,Kentucky,2039,16006,10674,715,27395,2020,Sep
2020-09,Louisiana,1677,15581,12661,1283,29525,2020,Sep
2020-09,Maine,912,4758,6249,373,11380,2020,Sep
2020-09,Mariana Islands,0,14,11,2,27,2020,Sep
2020-09,Maryland,11938,9575,8547,282,18404,2020,Sep
2020-09,Massachusetts,14163,6889,3754,878,11521,2020,Sep
2020-09,Michigan,29269,32590,25496,2391,60477,2020,Sep
2020-09,Minnesota,28892,16169,19127,1292,36588,2020,Sep
2020-09,Mississippi,2947,10668,8825,651,20144,2020,Sep
2020-09,Missouri,4316,24614,17708,2216,44538,2020,Sep
2020-09,Montana,2032,4903,6148,319,11370,2020,Sep
2020-09,Nebraska,6383,127,2362,23,2512,2020,Sep
2020-09,Nevada,2018,8773,3700,505,12978,2020,Sep
2020-09,New Hampshire,1719,6974,4420,189,11583,2020,Sep
2020-09,New Jersey,0,12591,7274,735,20600,2020,Sep
2020-09,New Mexico,1021,7960,5067,709,13736,2020,Sep
2020-09,New York,3389,9928,25663,3370,38961,2020,Sep
2020-09,North Carolina,47822,2274,19325,1531,23130,2020,Sep
2020-09,North Dakota,676,2339,3879,134,6352,2020,Sep
2020-09,Ohio,19438,32432,19759,1717,53908,2020,Sep
2020-09,Oklahoma,2714,14820,11176,1500,27496,2020,Sep
2020-09,Oregon,5494,20804,13091,0,33895,2020,Sep
2020-09,Pennsylvania,39823,68109,25277,46,93432,2020,Sep
2020-09,Puerto Rico,0,2560,261,64,2885,2020,Sep
2020-09,Rhode Island,0,2001,1165,133,3299,2020,Sep
2020-09,South Carolina,13912,14993,9264,915,25172,2020,Sep
2020-09,South Dakota,858,3588,4621,200,8409,2020,Sep
2020-09,Tennessee,13713,31341,19732,1661,52734,2020,Sep
2020-09,Texas,46746,68804,46463,4888,120155,2020,Sep
2020-09,Utah,18425,6762,5896,529,13187,2020,Sep
2020-09,Vermont,0,1973,2380,147,4500,2020,Sep
2020-09,Virgin Islands,51,34,1,0,35,2020,Sep
2020-09,Virginia,1087,31327,19565,4105,54997,2020,Sep
2020-09,Washington,18816,26363,15035,4062,45460,2020,Sep
2020-09,West Virginia,3242,6635,7065,380,14080,2020,Sep
2020-09,Wisconsin,21724,25970,17806,1448,45224,2020,Sep
2020-09,Wyoming,734,2722,3247,186,6155,2020,Sep
2020-08,Alabama,35838,26449,16913,1943,45305,2020,Aug
2020-08,Alaska,143,4088,4113,404,8605,2020,Aug
2020-08,Arizona,9377,25375,12472,2233,40080,2020,Aug
2020-08,Arkansas,3266,9821,7421,619,17861,2020,Aug
2020-08,California,33056,65196,38505,8409,112110,2020,Aug
2020-08,Colorado,11194,25765,16476,1948,44189,2020,Aug
2020-08,Connecticut,7600,5952,2014,1616,9582,2020,Aug
2020-08,Delaware,493,3402,1919,181,5502,2020,Aug
2020-08,District of Columbia,936,550,5,0,555,2020,Aug
2020-08,Florida,35826,85345,30914,6509,122768,2020,Aug
2020-08,Georgia,32131,26176,12198,1349,39723,2020,Aug
2020-08,Guam,0,151,39,57,247,2020,Aug
2020-08,Hawaii,1622,0,0,0,0,2020,Aug
2020-08,Idaho,3555,7860,6811,620,15291,2020,Aug
2020-08,Illinois,39261,28864,13330,0,42194,2020,Aug
2020-08,Indiana,1199,28843,16235,2226,47304,2020,Aug
2020-08,Iowa,8567,242,3223,54,3519,2020,Aug
2020-08,Kansas,1491,8851,6423,781,16055,2020,Aug
2020-08,Kentucky,2318,18531,10985,842,30358,2020,Aug
2020-08,Louisiana,1879,16826,10171,1568,28565,2020,Aug
2020-08,Maine,563,4734,4555,361,9650,2020,Aug
2020-08,Mariana Islands,0,9,6,1,16,2020,Aug
2020-08,Maryland,10133,8270,7807,248,16325,2020,Aug
2020-08,Massachusetts,12657,6756,3557,748,11061,2020,Aug
2020-08,Michigan,28773,35892,23104,2709,61705,2020,Aug
2020-08,Minnesota,26910,17297,15193,1311,33801,2020,Aug
2020-08,Mississippi,2773,15129,10518,928,26575,2020,Aug
2020-08,Missouri,4203,26351,17461,2343,46155,2020,Aug
2020-08,Montana,1928,5066,5441,340,10847,2020,Aug
2020-08,Nebraska,5990,140,2280,32,2452,2020,Aug
2020-08,Nevada,4578,9541,3884,575,14000,2020,Aug
2020-08,New Hampshire,1635,6952,4034,213,11199,2020,Aug
2020-08,New Jersey,0,10002,6258,518,16778,2020,Aug
2020-08,New Mexico,822,8580,5360,780,14720,2020,Aug
2020-08,New York,3065,10163,22460,3426,36049,2020,Aug
2020-08,North Carolina,51670,2534,18885,1603,23022,2020,Aug
2020-08,North Dakota,666,2503,3428,164,6095,2020,Aug
2020-08,Ohio,18116,37224,19937,2099,59260,2020,Aug
2020-08,Oklahoma,2784,15728,10666,1672,28066,2020,Aug
2020-08,Oregon,5793,21080,12694,0,33774,2020,Aug
2020-08,Pennsylvania,36025,69325,24361,37,93723,2020,Aug
2020-08,Puerto Rico,0,2441,250,73,2764,2020,Aug
2020-08,Rhode Island,0,1842,1081,125,3048,2020,Aug
2020-08,South Carolina,11598,17111,9137,1043,27291,2020,Aug
2020-08,South Dakota,824,3700,4105,235,8040,2020,Aug
2020-08,Tennessee,11438,35007,21069,1837,57913,2020,Aug
2020-08,Texas,50347,77807,43770,5975,127552,2020,Aug
2020-08,Utah,20777,6483,5303,581,12367,2020,Aug
2020-08,Vermont,0,2128,1898,183,4209,2020,Aug
2020-08,Virgin Islands,37,22,2,1,25,2020,Aug
2020-08,Virginia,900,36314,20016,4525,60855,2020,Aug
2020-08,Washington,16546,28536,14497,4259,47292,2020,Aug
2020-08,West Virginia,3176,7487,6958,455,14900,2020,Aug
2020-08,Wisconsin,18816,28102,15908,1485,45495,2020,Aug
2020-08,Wyoming,522,3080,3188,220,6488,2020,Aug
2020-07,Alabama,48126,34909,17250,2498,54657,2020,Jul
2020-07,Alaska,69,4949,3779,435,9163,2020,Jul
2020-07,Arizona,9402,31040,12361,2411,45812,2020,Jul
2020-07,Arkansas,4292,12391,7322,738,20451,2020,Jul
2020-07,California,35097,67672,38618,7530,113820,2020,Jul
2020-07,Colorado,11124,29171,15184,2077,46432,2020,Jul
2020-07,Connecticut,8500,6815,2062,1791,10668,2020,Jul
2020-07,Delaware,445,4034,1840,249,6123,2020,Jul
2020-07,District of Columbia,575,296,11,0,307,2020,Jul
2020-07,Florida,33826,106745,33102,7751,147598,2020,Jul
2020-07,Georgia,37840,38413,13344,1700,53457,2020,Jul
2020-07,Guam,0,227,85,54,366,2020,Jul
2020-07,Hawaii,1840,0,0,0,0,2020,Jul
2020-07,Idaho,6450,8813,6337,752,15902,2020,Jul
2020-07,Illinois,42167,31853,12250,0,44103,2020,Jul
2020-07,Indiana,1117,32970,15066,2395,50431,2020,Jul
2020-07,Iowa,11431,248,2685,45,2978,2020,Jul
2020-07,Kansas,2125,10300,6071,833,17204,2020,Jul
2020-07,Kentucky,1481,20962,10578,947,32487,2020,Jul
2020-07,Louisiana,1932,24074,11374,1980,37428,2020,Jul
2020-07,Maine,664,5163,4049,398,9610,2020,Jul
2020-07,Mariana Islands,0,13,6,1,20,2020,Jul
2020-07,Maryland,9374,7905,8023,347,16275,2020,Jul
2020-07,Massachusetts,13334,6238,3114,730,10082,2020,Jul
2020-07,Michigan,28959,44270,21710,2909,68889,2020,Jul
2020-07,Minnesota,27663,17856,11371,1397,30624,2020,Jul
2020-07,Mississippi,3486,19196,8971,1119,29286,2020,Jul
2020-07,Missouri,5289,31991,17146,2753,51890,2020,Jul
2020-07,Montana,1971,5472,4926,339,10737,2020,Jul
2020-07,Nebraska,6481,135,1929,34,2098,2020,Jul
2020-07,Nevada,3978,11920,3949,658,16527,2020,Jul
2020-07,New Hampshire,1666,7918,3788,213,11919,2020,Jul
2020-07,New Jersey,0,7656,6172,448,14276,2020,Jul
2020-07,New Mexico,195,10102,5084,768,15954,2020,Jul
2020-07,New York,3266,11400,23105,4019,38524,2020,Jul
2020-07,North Carolina,54287,2865,20322,1965,25152,2020,Jul
2020-07,North Dakota,606,2702,2942,170,5814,2020,Jul
2020-07,Ohio,18219,43645,18865,2325,64835,2020,Jul
2020-07,Oklahoma,2873,19294,10955,2027,32276,2020,Jul
2020-07,Oregon,5945,22479,11897,0,34376,2020,Jul
2020-07,Pennsylvania,41217,77854,22276,68,100198,2020,Jul
2020-07,Puerto Rico,0,2283,256,107,2646,2020,Jul
2020-07,Rhode Island,0,2079,1142,139,3360,2020,Jul
2020-07,South Carolina,11394,23255,8726,1231,33212,2020,Jul
2020-07,South Dakota,788,3609,3222,254,7085,2020,Jul
2020-07,Tennessee,13825,42011,20831,2075,64917,2020,Jul
2020-07,Texas,58415,96689,41060,6431,144180,2020,Jul
2020-07,Utah,10244,8314,5447,744,14505,2020,Jul
2020-07,Vermont,0,2373,1739,199,4311,2020,Jul
2020-07,Virgin Islands,208,48,4,0,52,2020,Jul
2020-07,Virginia,732,44801,19538,5588,69927,2020,Jul
2020-07,Washington,15562,33892,14006,4980,52878,2020,Jul
2020-07,West Virginia,4184,9331,6358,479,16168,2020,Jul
2020-07,Wisconsin,17704,26890,12518,1273,40681,2020,Jul
2020-07,Wyoming,818,3237,2950,207,6394,2020,Jul
2020-06,Alabama,64643,47159,20120,2604,69883,2020,Jun
2020-06,Alaska,19,4785,3091,451,8327,2020,Jun
2020-06,Arizona,7390,43291,14267,2769,60327,2020,Jun
2020-06,Arkansas,4203,15520,7820,785,24125,2020,Jun
2020-06,California,31700,76210,40933,8487,125630,2020,Jun
2020-06,Colorado,9000,35381,16998,2250,54629,2020,Jun
2020-06,Connecticut,6641,6943,2196,2178,11317,2020,Jun
2020-06,Delaware,207,5303,2116,204,7623,2020,Jun
2020-06,District of Columbia,647,217,0,0,217,2020,Jun
2020-06,Florida,20676,133285,39111,7341,179737,2020,Jun
2020-06,Georgia,37635,46989,14779,1663,63431,2020,Jun
2020-06,Guam,0,243,100,36,379,2020,Jun
2020-06,Hawaii,1655,0,0,0,0,2020,Jun
2020-06,Idaho,8647,10802,7430,801,19033,2020,Jun
2020-06,Illinois,73508,49101,14913,0,64014,2020,Jun
2020-06,Indiana,1097,40492,16560,2561,59613,2020,Jun
2020-06,Iowa,12845,319,4009,80,4408,2020,Jun
2020-06,Kansas,1632,12829,6276,853,19958,2020,Jun
2020-06,Kentucky,1175,27051,11707,993,39751,2020,Jun
2020-06,Louisiana,1326,28289,11116,1774,41179,2020,Jun
2020-06,Maine,526,6583,4059,468,11110,2020,Jun
2020-06,Mariana Islands,0,10,6,0,16,2020,Jun
2020-06,Maryland,6576,8818,9524,464,18806,2020,Jun
2020-06,Massachusetts,10914,7923,3881,921,12725,2020,Jun
2020-06,Michigan,24814,51216,23784,3149,78149,2020,Jun
2020-06,Minnesota,30531,17758,12316,1435,31509,2020,Jun
2020-06,Mississippi,842,23505,9291,886,33682,2020,Jun
2020-06,Missouri,6086,38153,17472,2786,58411,2020,Jun
2020-06,Montana,2276,6573,5803,389,12765,2020,Jun
2020-06,Nebraska,6205,179,2474,34,2687,2020,Jun
2020-06,Nevada,3565,14420,4220,656,19296,2020,Jun
2020-06,New Hampshire,1943,9911,4211,198,14320,2020,Jun
2020-06,New Jersey,0,6921,6077,457,13455,2020,Jun
2020-06,New Mexico,559,11828,5984,880,18692,2020,Jun
2020-06,New York,1984,11585,31003,4735,47323,2020,Jun
2020-06,North Carolina,55925,3380,25843,2162,31385,2020,Jun
2020-06,North Dakota,461,3426,3373,201,7000,2020,Jun
2020-06,Ohio,15031,54811,21686,2452,78949,2020,Jun
2020-06,Oklahoma,3036,24400,11222,1987,37609,2020,Jun
2020-06,Oregon,5691,27187,13974,0,41161,2020,Jun
2020-06,Pennsylvania,35753,90652,24029,66,114747,2020,Jun
2020-06,Puerto Rico,0,2838,302,153,3293,2020,Jun
2020-06,Rhode Island,0,2453,1702,177,4332,2020,Jun
2020-06,South Carolina,11029,30837,9991,1338,42166,2020,Jun
2020-06,South Dakota,844,4487,3492,276,8255,2020,Jun
2020-06,Tennessee,16200,50593,21516,2293,74402,2020,Jun
2020-06,Texas,41486,121926,45845,6857,174628,2020,Jun
2020-06,Utah,11993,10796,6292,761,17849,2020,Jun
2020-06,Vermont,0,2702,1872,201,4775,2020,Jun
2020-06,Virgin Islands,117,29,3,0,32,2020,Jun
2020-06,Virginia,455,55177,21748,6338,83263,2020,Jun
2020-06,Washington,11153,35924,15646,7431,59001,2020,Jun
2020-06,West Virginia,3713,11554,7043,528,19125,2020,Jun
2020-06,Wisconsin,17284,35081,13619,1560,50260,2020,Jun
2020-06,Wyoming,359,3966,2946,238,7150,2020,Jun
2020-05,Alabama,28064,32394,13899,1468,47761,2020,May
2020-05,Alaska,55,4469,3196,429,8094,2020,May
2020-05,Arizona,4737,28089,11334,2053,41476,2020,May
2020-05,Arkansas,3868,11572,7005,528,19105,2020,May
2020-05,California,23948,50811,28550,6499,85860,2020,May
2020-05,Colorado,3946,27297,15043,1998,44338,2020,May
2020-05,Connecticut,2732,4654,1673,1714,8041,2020,May
2020-05,Delaware,325,2899,1238,165,4302,2020,May
2020-05,District of Columbia,413,109,1,0,110,2020,May
2020-05,Florida,6723,73691,22529,5156,101376,2020,May
2020-05,Georgia,12489,34434,11489,1139,47062,2020,May
2020-05,Guam,0,207,88,30,325,2020,May
2020-05,Hawaii,1493,0,0,0,0,2020,May
2020-05,Idaho,5095,8228,6848,635,15711,2020,May
2020-05,Illinois,25190,26854,9959,0,36813,2020,May
2020-05,Indiana,657,30133,14420,2221,46774,2020,May
2020-05,Iowa,6292,287,2825,77,3189,2020,May
2020-05,Kansas,2129,10020,5595,869,16484,2020,May
2020-05,Kentucky,466,20881,11275,823,32979,2020,May
2020-05,Louisiana,546,20064,8025,1174,29263,2020,May
2020-05,Maine,595,5374,3724,515,9613,2020,May
2020-05,Mariana Islands,0,8,4,1,13,2020,May
2020-05,Maryland,5012,5975,6775,207,12957,2020,May
2020-05,Massachusetts,6596,5743,2665,889,9297,2020,May
2020-05,Michigan,11113,39342,20339,2949,62630,2020,May
2020-05,Minnesota,11641,13770,11706,1152,26628,2020,May
2020-05,Mississippi,80,18313,7363,555,26231,2020,May
2020-05,Missouri,3705,31302,16484,2308,50094,2020,May
2020-05,Montana,1650,5835,5797,362,11994,2020,May
2020-05,Nebraska,3168,120,2026,23,2169,2020,May
2020-05,Nevada,1276,10720,3997,710,15427,2020,May
2020-05,New Hampshire,912,7797,3760,211,11768,2020,May
2020-05,New Jersey,0,5316,3859,414,9589,2020,May
2020-05,New Mexico,443,9638,4888,749,15275,2020,May
2020-05,New York,2452,5312,14212,2581,22105,2020,May
2020-05,North Carolina,34964,2365,18508,1631,22504,2020,May
2020-05,North Dakota,262,2734,2740,183,5657,2020,May
2020-05,Ohio,8302,37486,17996,2268,57750,2020,May
2020-05,Oklahoma,2128,18787,9863,1571,30221,2020,May
2020-05,Oregon,4380,22539,13415,0,35954,2020,May
2020-05,Pennsylvania,14063,56455,16255,85,72795,2020,May
2020-05,Puerto Rico,0,1252,135,55,1442,2020,May
2020-05,Rhode Island,0,1571,926,101,2598,2020,May
2020-05,South Carolina,8621,22675,7524,1154,31353,2020,May
2020-05,South Dakota,353,3342,3037,199,6578,2020,May
2020-05,Tennessee,8533,38522,17799,1869,58190,2020,May
2020-05,Texas,41584,83977,36456,5393,125826,2020,May
2020-05,Utah,10937,7550,5265,559,13374,2020,May
2020-05,Vermont,0,2660,1948,194,4802,2020,May
2020-05,Virgin Islands,25,9,0,0,9,2020,May
2020-05,Virginia,298,36930,16775,4568,58273,2020,May
2020-05,Washington,7121,26162,12578,4963,43703,2020,May
2020-05,West Virginia,1229,10193,7152,532,17877,2020,May
2020-05,Wisconsin,10120,25506,11577,1226,38309,2020,May
2020-05,Wyoming,101,2902,2591,255,5748,2020,May
2020-04,Alabama,21276,28951,12512,1455,42918,2020,Apr
2020-04,Alaska,85,3942,3275,510,7727,2020,Apr
2020-04,Arizona,4500,33391,13143,2369,48903,2020,Apr
2020-04,Arkansas,3085,13814,8463,612,22889,2020,Apr
2020-04,California,24460,59219,31759,6330,97308,2020,Apr
2020-04,Colorado,1763,29865,16199,2133,48197,2020,Apr
2020-04,Connecticut,3796,4921,1802,2294,9017,2020,Apr
2020-04,Delaware,359,3572,1308,185,5065,2020,Apr
2020-04,District of Columbia,444,100,1,0,101,2020,Apr
2020-04,Florida,2258,84431,26731,4897,116059,2020,Apr
2020-04,Georgia,589,33720,11724,1162,46606,2020,Apr
2020-04,Guam,0,132,59,23,214,2020,Apr
2020-04,Hawaii,1815,0,0,0,0,2020,Apr
2020-04,Idaho,3146,9248,7050,696,16994,2020,Apr
2020-04,Illinois,25857,30500,11184,0,41684,2020,Apr
2020-04,Indiana,233,29904,14843,2332,47079,2020,Apr
2020-04,Iowa,8998,296,3284,79,3659,2020,Apr
2020-04,Kansas,255,10417,5632,863,16912,2020,Apr
2020-04,Kentucky,1555,20712,12196,820,33728,2020,Apr
2020-04,Louisiana,986,18563,7462,1117,27142,2020,Apr
2020-04,Maine,607,6054,3835,594,10483,2020,Apr
2020-04,Mariana Islands,0,7,1,1,9,2020,Apr
2020-04,Maryland,6245,5717,8524,101,14342,2020,Apr
2020-04,Massachusetts,5074,1407,674,710,2791,2020,Apr
2020-04,Michigan,9765,23375,13600,2507,39482,2020,Apr
2020-04,Minnesota,12876,13792,10295,1371,25458,2020,Apr
2020-04,Mississippi,200,17677,7256,586,25519,2020,Apr
2020-04,Missouri,774,32009,17962,2470,52441,2020,Apr
2020-04,Montana,962,6010,5399,454,11863,2020,Apr
2020-04,Nebraska,4917,146,2177,47,2370,2020,Apr
2020-04,Nevada,738,12225,3870,619,16714,2020,Apr
2020-04,New Hampshire,1171,8801,4512,259,13572,2020,Apr
2020-04,New Jersey,0,4388,4266,311,8965,2020,Apr
2020-04,New Mexico,367,7439,3798,648,11885,2020,Apr
2020-04,New York,2920,2853,16007,2918,21778,2020,Apr
2020-04,North Carolina,37217,2199,20928,1705,24832,2020,Apr
2020-04,North Dakota,280,3041,2898,204,6143,2020,Apr
2020-04,Ohio,6057,37486,18560,2295,58341,2020,Apr
2020-04,Oklahoma,2076,21398,11308,1617,34323,2020,Apr
2020-04,Oregon,5267,25187,13572,0,38759,2020,Apr
2020-04,Pennsylvania,6473,54041,14778,40,68859,2020,Apr
2020-04,Puerto Rico,0,76,10,7,93,2020,Apr
2020-04,Rhode Island,0,1841,1247,126,3214,2020,Apr
2020-04,South Carolina,6990,21071,7502,866,29439,2020,Apr
2020-04,South Dakota,248,4171,3177,282,7630,2020,Apr
2020-04,Tennessee,18458,38309,19001,1974,59284,2020,Apr
2020-04,Texas,38817,93980,40921,5668,140569,2020,Apr
2020-04,Utah,15827,9834,6501,676,17011,2020,Apr
2020-04,Vermont,0,3081,2142,223,5446,2020,Apr
2020-04,Virgin Islands,47,2,0,0,2,2020,Apr
2020-04,Virginia,108,40444,19116,4949,64509,2020,Apr
2020-04,Washington,6873,29785,12837,4428,47050,2020,Apr
2020-04,West Virginia,655,10120,7913,480,18513,2020,Apr
2020-04,Wisconsin,13623,27220,11806,1406,40432,2020,Apr
2020-04,Wyoming,476,3988,3102,327,7417,2020,Apr
2020-03,Alabama,31205,34897,17850,1583,54330,2020,Mar
2020-03,Alaska,143,4657,3819,487,8963,2020,Mar
2020-03,Arizona,5685,46377,19346,2433,68156,2020,Mar
2020-03,Arkansas,2424,15304,8968,600,24872,2020,Mar
2020-03,California,27792,81543,48616,5041,135200,2020,Mar
2020-03,Colorado,5654,43322,22756,2086,68164,2020,Mar
2020-03,Connecticut,4852,9196,3290,5421,17907,2020,Mar
2020-03,Delaware,227,4936,2323,190,7449,2020,Mar
2020-03,District of Columbia,474,148,5,0,153,2020,Mar
2020-03,Florida,16713,117900,38365,5017,161282,2020,Mar
2020-03,Georgia,16741,44107,16807,1245,62159,2020,Mar
2020-03,Guam,0,170,80,11,261,2020,Mar
2020-03,Hawaii,1842,0,0,0,0,2020,Mar
2020-03,Idaho,8647,11611,8193,716,20520,2020,Mar
2020-03,Illinois,39780,44112,17127,0,61239,2020,Mar
2020-03,Indiana,585,45695,22724,2613,71032,2020,Mar
2020-03,Iowa,9606,378,5778,91,6247,2020,Mar
2020-03,Kansas,898,16715,8964,889,26568,2020,Mar
2020-03,Kentucky,2394,28268,15315,937,44520,2020,Mar
2020-03,Louisiana,1620,25038,10278,1258,36574,2020,Mar
2020-03,Maine,278,7794,5310,510,13614,2020,Mar
2020-03,Mariana Islands,0,4,1,0,5,2020,Mar
2020-03,Maryland,5810,6534,16181,335,23050,2020,Mar
2020-03,Massachusetts,7329,9765,5100,759,15624,2020,Mar
2020-03,Michigan,18153,50368,28985,2724,82077,2020,Mar
2020-03,Minnesota,22114,18708,17222,1562,37492,2020,Mar
2020-03,Mississippi,1965,18567,8714,592,27873,2020,Mar
2020-03,Missouri,3500,41905,22607,2610,67122,2020,Mar
2020-03,Montana,1783,6755,5895,500,13150,2020,Mar
2020-03,Nebraska,6979,217,3623,45,3885,2020,Mar
2020-03,Nevada,1990,13530,4712,483,18725,2020,Mar
2020-03,New Hampshire,1417,14278,6190,348,20816,2020,Mar
2020-03,New Jersey,0,4531,6000,286,10817,2020,Mar
2020-03,New Mexico,602,13558,7181,804,21543,2020,Mar
2020-03,New York,3500,9257,39906,4288,53451,2020,Mar
2020-03,North Carolina,40903,2488,31949,2016,36453,2020,Mar
2020-03,North Dakota,587,4122,3717,246,8085,2020,Mar
2020-03,Ohio,12100,63707,28817,2793,95317,2020,Mar
2020-03,Oklahoma,2821,25804,13873,1725,41402,2020,Mar
2020-03,Oregon,5618,33659,18838,0,52497,2020,Mar
2020-03,Pennsylvania,20598,81319,22031,30,103380,2020,Mar
2020-03,Puerto Rico,0,660,104,34,798,2020,Mar
2020-03,Rhode Island,0,2533,2303,178,5014,2020,Mar
2020-03,South Carolina,10501,25288,10790,1017,37095,2020,Mar
2020-03,South Dakota,491,5536,4230,337,10103,2020,Mar
2020-03,Tennessee,10431,49546,25157,2954,77657,2020,Mar
2020-03,Texas,35688,147714,61827,5897,215438,2020,Mar
2020-03,Utah,15658,13908,8665,628,23201,2020,Mar
2020-03,Vermont,0,3853,2636,238,6727,2020,Mar
2020-03,Virgin Islands,99,21,2,0,23,2020,Mar
2020-03,Virginia,386,51801,24208,6848,82857,2020,Mar
2020-03,Washington,13504,32624,20165,5234,58023,2020,Mar
2020-03,West Virginia,2186,11570,8599,564,20733,2020,Mar
2020-03,Wisconsin,14263,42224,18582,1627,62433,2020,Mar
2020-03,Wyoming,414,4155,3349,299,7803,2020,Mar
2020-02,Alabama,29633,24590,12531,1225,38346,2020,Feb
2020-02,Alaska,139,2560,1839,311,4710,2020,Feb
2020-02,Arizona,6138,16839,8006,1424,26269,2020,Feb
2020-02,Arkansas,2994,8112,5453,363,13928,2020,Feb
2020-02,California,32002,35570,22645,4221,62436,2020,Feb
2020-02,Colorado,6336,19931,11285,1505,32721,2020,Feb
2020-02,Connecticut,5679,5341,1961,3468,10770,2020,Feb
2020-02,Delaware,413,2103,1386,130,3619,2020,Feb
2020-02,District of Columbia,403,97,4,0,101,2020,Feb
2020-02,Florida,21258,59653,20306,3748,83707,2020,Feb
2020-02,Georgia,21221,19173,8207,752,28132,2020,Feb
2020-02,Guam,0,161,67,10,238,2020,Feb
2020-02,Hawaii,1263,0,0,0,0,2020,Feb
2020-02,Idaho,6945,5286,4371,420,10077,2020,Feb
2020-02,Illinois,13769,22743,9761,0,32504,2020,Feb
2020-02,Indiana,564,25949,12739,1974,40662,2020,Feb
2020-02,Iowa,7512,220,2419,48,2687,2020,Feb
2020-02,Kansas,1588,7905,5610,653,14168,2020,Feb
2020-02,Kentucky,1993,15294,8763,668,24725,2020,Feb
2020-02,Louisiana,1875,12303,6564,734,19601,2020,Feb
2020-02,Maine,403,3920,2871,339,7130,2020,Feb
2020-02,Mariana Islands,0,12,3,0,15,2020,Feb
2020-02,Maryland,4323,4472,5622,140,10234,2020,Feb
2020-02,Massachusetts,9173,5745,2711,538,8994,2020,Feb
2020-02,Michigan,17941,14668,9092,901,24661,2020,Feb
2020-02,Minnesota,12130,11142,9395,990,21527,2020,Feb
2020-02,Mississippi,2378,11638,6114,407,18159,2020,Feb
2020-02,Missouri,3922,23420,14384,1965,39769,2020,Feb
2020-02,Montana,1968,3343,3196,293,6832,2020,Feb
2020-02,Nebraska,4458,177,1764,36,1977,2020,Feb
2020-02,Nevada,2633,6215,2706,376,9297,2020,Feb
2020-02,New Hampshire,1415,6031,2740,241,9012,2020,Feb
2020-02,New Jersey,0,4603,3580,224,8407,2020,Feb
2020-02,New Mexico,634,7615,4152,633,12400,2020,Feb
2020-02,New York,3493,9861,13360,2002,25223,2020,Feb
2020-02,North Carolina,29736,1984,13177,1191,16352,2020,Feb
2020-02,North Dakota,396,2122,2471,166,4759,2020,Feb
2020-02,Ohio,12123,29360,14843,2448,46651,2020,Feb
2020-02,Oklahoma,2799,16480,8203,1300,25983,2020,Feb
2020-02,Oregon,5387,16784,10360,0,27144,2020,Feb
2020-02,Pennsylvania,23294,53384,15473,53,68910,2020,Feb
2020-02,Puerto Rico,0,1540,126,45,1711,2020,Feb
2020-02,Rhode Island,0,1307,723,108,2138,2020,Feb
2020-02,South Carolina,11212,14700,6120,865,21685,2020,Feb
2020-02,South Dakota,534,3359,3195,246,6800,2020,Feb
2020-02,Tennessee,8152,32364,15464,1688,49516,2020,Feb
2020-02,Texas,31375,60512,29259,3956,93727,2020,Feb
2020-02,Utah,14928,4153,3460,378,7991,2020,Feb
2020-02,Vermont,0,1870,1514,157,3541,2020,Feb
2020-02,Virgin Islands,35,33,2,0,35,2020,Feb
2020-02,Virginia,686,36608,20509,8746,65863,2020,Feb
2020-02,Washington,13676,18044,9505,4021,31570,2020,Feb
2020-02,West Virginia,2400,8200,6163,462,14825,2020,Feb
2020-02,Wisconsin,10071,17509,11891,1148,30548,2020,Feb
2020-02,Wyoming,502,2322,1975,170,4467,2020,Feb
2020-01,Alabama,37140,22478,12598,1313,36389,2020,Jan
2020-01,Alaska,223,2151,1529,312,3992,2020,Jan
2020-01,Arizona,5727,15126,7087,1475,23688,2020,Jan
2020-01,Arkansas,3094,6621,5524,435,12580,2020,Jan
2020-01,California,34694,34884,22057,4131,61072,2020,Jan
2020-01,Colorado,7802,19614,11451,1757,32822,2020,Jan
2020-01,Connecticut,6570,5820,2187,694,8701,2020,Jan
2020-01,Delaware,459,2096,1524,143,3763,2020,Jan
2020-01,District of Columbia,511,124,4,0,128,2020,Jan
2020-01,Florida,21461,54985,19973,3957,78915,2020,Jan
2020-01,Georgia,25933,14422,7886,797,23105,2020,Jan
2020-01,Guam,0,155,56,10,221,2020,Jan
2020-01,Hawaii,1181,0,0,0,0,2020,Jan
2020-01,Idaho,7050,4359,3607,496,8462,2020,Jan
2020-01,Illinois,17551,22567,9588,0,32155,2020,Jan
2020-01,Indiana,846,22340,12461,2166,36967,2020,Jan
2020-01,Iowa,7776,198,2030,50,2278,2020,Jan
2020-01,Kansas,1658,6624,5196,702,12522,2020,Jan
2020-01,Kentucky,2314,12022,7558,704,20284,2020,Jan
2020-01,Louisiana,1988,10706,7687,798,19191,2020,Jan
2020-01,Maine,464,3534,2661,351,6546,2020,Jan
2020-01,Mariana Islands,0,18,6,1,25,2020,Jan
2020-01,Maryland,3985,4283,5213,118,9614,2020,Jan
2020-01,Massachusetts,9289,5182,2833,628,8643,2020,Jan
2020-01,Michigan,20493,11806,8250,941,20997,2020,Jan
2020-01,Minnesota,11108,9445,7565,974,17984,2020,Jan
2020-01,Mississippi,2223,8790,5922,445,15157,2020,Jan
2020-01,Missouri,4059,20436,13149,2065,35650,2020,Jan
2020-01,Montana,2011,2884,3010,271,6165,2020,Jan
2020-01,Nebraska,4794,110,1923,35,2068,2020,Jan
2020-01,Nevada,2177,5250,2413,356,8019,2020,Jan
2020-01,New Hampshire,1576,5771,2913,341,9025,2020,Jan
2020-01,New Jersey,0,4349,3639,205,8193,2020,Jan
2020-01,New Mexico,529,6783,3648,573,11004,2020,Jan
2020-01,New York,4095,10227,12610,2058,24895,2020,Jan
2020-01,North Carolina,33070,1836,12908,1316,16060,2020,Jan
2020-01,North Dakota,370,1771,2258,158,4187,2020,Jan
2020-01,Ohio,13211,24218,13069,2066,39353,2020,Jan
2020-01,Oklahoma,2814,14939,8277,1346,24562,2020,Jan
2020-01,Oregon,6271,15332,9167,0,24499,2020,Jan
2020-01,Pennsylvania,27221,46160,13636,70,59866,2020,Jan
2020-01,Puerto Rico,0,1559,139,75,1773,2020,Jan
2020-01,Rhode Island,0,1279,844,118,2241,2020,Jan
2020-01,South Carolina,9740,11488,5795,969,18252,2020,Jan
2020-01,South Dakota,634,2782,2897,214,5893,2020,Jan
2020-01,Tennessee,7872,28938,14788,1507,45233,2020,Jan
2020-01,Texas,29676,53796,29103,4092,86991,2020,Jan
2020-01,Utah,11152,3552,2959,387,6898,2020,Jan
2020-01,Vermont,0,1500,1278,159,2937,2020,Jan
2020-01,Virgin Islands,113,33,3,0,36,2020,Jan
2020-01,Virginia,360,36391,21424,9713,67528,2020,Jan
2020-01,Washington,15767,18390,8842,3813,31045,2020,Jan
2020-01,West Virginia,2697,6543,5664,422,12629,2020,Jan
2020-01,Wisconsin,11587,14521,9835,1168,25524,2020,Jan
2020-01,Wyoming,550,2135,1656,185,3976,2020,Jan
2019-12,Alabama,33683,33020,25882,1560,60462,2019,Dec
2019-12,Alaska,386,3455,3080,397,6932,2019,Dec
2019-12,Arizona,4536,18178,10423,1560,30161,2019,Dec
2019-12,Arkansas,2339,8671,10957,531,20159,2019,Dec
2019-12,California,29544,40637,30780,4883,76300,2019,Dec
2019-12,Colorado,4867,22531,16681,1762,40974,2019,Dec
2019-12,Connecticut,4329,5655,2215,706,8576,2019,Dec
2019-12,Delaware,153,2075,2301,120,4496,2019,Dec
2019-12,District of Columbia,623,101,1,0,102,2019,Dec
2019-12,Florida,15238,67435,31580,4458,103473,2019,Dec
2019-12,Georgia,19493,21514,17664,880,40058,2019,Dec
2019-12,Guam,0,180,86,18,284,2019,Dec
2019-12,Hawaii,1195,0,0,0,0,2019,Dec
2019-12,Idaho,5207,6745,7111,514,14370,2019,Dec
2019-12,Illinois,15241,24792,13258,0,38050,2019,Dec
2019-12,Indiana,757,26770,18746,2075,47591,2019,Dec
2019-12,Iowa,6589,271,4421,81,4773,2019,Dec
2019-12,Kansas,1324,8092,8653,716,17461,2019,Dec
2019-12,Kentucky,1160,16185,14471,729,31385,2019,Dec
2019-12,Louisiana,943,14237,16743,912,31892,2019,Dec
2019-12,Maine,301,3651,4119,348,8118,2019,Dec
2019-12,Mariana Islands,0,8,0,2,10,2019,Dec
2019-12,Maryland,3446,4175,6878,186,11239,2019,Dec
2019-12,Massachusetts,6973,4516,2789,510,7815,2019,Dec
2019-12,Michigan,15746,14303,14075,1008,29386,2019,Dec
2019-12,Minnesota,9676,9835,11241,1023,22099,2019,Dec
2019-12,Mississippi,1515,12935,14538,536,28009,2019,Dec
2019-12,Missouri,3695,26084,22222,2346,50652,2019,Dec
2019-12,Montana,1365,4169,5522,301,9992,2019,Dec
2019-12,Nebraska,4689,173,3205,44,3422,2019,Dec
2019-12,Nevada,1622,6307,3636,385,10328,2019,Dec
2019-12,New Hampshire,1081,5471,3255,322,9048,2019,Dec
2019-12,New Jersey,0,3747,4341,216,8304,2019,Dec
2019-12,New Mexico,760,7794,5184,584,13562,2019,Dec
2019-12,New York,3069,8899,16654,1517,27070,2019,Dec
2019-12,North Carolina,23541,2559,22945,1295,26799,2019,Dec
2019-12,North Dakota,261,2155,3171,175,5501,2019,Dec
2019-12,Ohio,9850,31054,23312,2223,56589,2019,Dec
2019-12,Oklahoma,2309,19110,14320,1574,35004,2019,Dec
2019-12,Oregon,5009,17610,14016,0,31626,2019,Dec
2019-12,Pennsylvania,21995,53180,20278,32,73490,2019,Dec
2019-12,Puerto Rico,0,1767,195,131,2093,2019,Dec
2019-12,Rhode Island,0,1117,794,84,1995,2019,Dec
2019-12,South Carolina,7891,14905,11857,1005,27767,2019,Dec
2019-12,South Dakota,467,3264,4482,262,8008,2019,Dec
2019-12,Tennessee,10319,35893,26800,1899,64592,2019,Dec
2019-12,Texas,25456,69732,53386,4713,127831,2019,Dec
2019-12,Utah,11139,5893,6783,407,13083,2019,Dec
2019-12,Vermont,0,1610,1613,151,3374,2019,Dec
2019-12,Virgin Islands,78,32,0,0,32,2019,Dec
2019-12,Virginia,392,37790,29539,8357,75686,2019,Dec
2019-12,Washington,13500,20508,11752,3724,35984,2019,Dec
2019-12,West Virginia,1616,8815,9944,415,19174,2019,Dec
2019-12,Wisconsin,7738,17195,14486,1223,32904,2019,Dec
2019-12,Wyoming,543,3293,3077,212,6582,2019,Dec
2019-11,Alabama,26375,24005,19212,1161,44378,2019,Nov
2019-11,Alaska,238,3003,2980,368,6351,2019,Nov
2019-11,Arizona,4524,13775,8180,1131,23086,2019,Nov
2019-11,Arkansas,2319,6814,9628,321,16763,2019,Nov
2019-11,California,29002,34345,25063,3564,62972,2019,Nov
2019-11,Colorado,4765,17950,13946,1475,33371,2019,Nov
2019-11,Connecticut,5513,4908,2321,692,7921,2019,Nov
2019-11,Delaware,154,1684,2063,95,3842,2019,Nov
2019-11,District of Columbia,459,103,1,0,104,2019,Nov
2019-11,Florida,14070,54799,24497,3666,82962,2019,Nov
2019-11,Georgia,14625,16171,13002,653,29826,2019,Nov
2019-11,Guam,0,98,65,12,175,2019,Nov
2019-11,Hawaii,921,0,0,0,0,2019,Nov
2019-11,Idaho,5124,4875,5774,426,11075,2019,Nov
2019-11,Illinois,12356,21597,12115,0,33712,2019,Nov
2019-11,Indiana,668,21903,17950,1776,41629,2019,Nov
2019-11,Iowa,6123,348,4487,58,4893,2019,Nov
2019-11,Kansas,1040,7143,7349,606,15098,2019,Nov
2019-11,Kentucky,1372,12094,12686,528,25308,2019,Nov
2019-11,Louisiana,620,11282,13282,687,25251,2019,Nov
2019-11,Maine,278,2839,4424,292,7555,2019,Nov
2019-11,Mariana Islands,0,6,6,1,13,2019,Nov
2019-11,Maryland,3281,3447,7153,140,10740,2019,Nov
2019-11,Massachusetts,8291,4651,2868,541,8060,2019,Nov
2019-11,Michigan,13890,13255,19391,747,33393,2019,Nov
2019-11,Minnesota,8681,9148,13550,902,23600,2019,Nov
2019-11,Mississippi,1509,9210,11603,439,21252,2019,Nov
2019-11,Missouri,2721,21090,21032,1659,43781,2019,Nov
2019-11,Montana,1082,3032,4517,226,7775,2019,Nov
2019-11,Nebraska,2928,128,2954,21,3103,2019,Nov
2019-11,Nevada,1546,4892,2873,340,8105,2019,Nov
2019-11,New Hampshire,1001,4803,3289,291,8383,2019,Nov
2019-11,New Jersey,0,3721,3914,200,7835,2019,Nov
2019-11,New Mexico,540,6317,4586,527,11430,2019,Nov
2019-11,New York,3276,8355,18336,1329,28020,2019,Nov
2019-11,North Carolina,20804,2394,18720,1086,22200,2019,Nov
2019-11,North Dakota,274,1731,3237,135,5103,2019,Nov
2019-11,Ohio,9271,25230,24933,2034,52197,2019,Nov
2019-11,Oklahoma,2483,18679,12894,1279,32852,2019,Nov
2019-11,Oregon,4844,15105,11503,0,26608,2019,Nov
2019-11,Pennsylvania,18877,49972,22212,39,72223,2019,Nov
2019-11,Puerto Rico,0,1902,203,114,2219,2019,Nov
2019-11,Rhode Island,0,1039,747,57,1843,2019,Nov
2019-11,South Carolina,7254,11531,9303,822,21656,2019,Nov
2019-11,South Dakota,409,2687,4634,205,7526,2019,Nov
2019-11,Tennessee,8140,27826,21101,1706,50633,2019,Nov
2019-11,Texas,23710,57252,41942,3592,102786,2019,Nov
2019-11,Utah,11392,4095,5038,388,9521,2019,Nov
2019-11,Vermont,0,1176,1739,106,3021,2019,Nov
2019-11,Virgin Islands,218,21,2,0,23,2019,Nov
2019-11,Virginia,438,27949,23374,5338,56661,2019,Nov
2019-11,Washington,11440,13487,10163,2902,26552,2019,Nov
2019-11,West Virginia,1536,5980,9834,299,16113,2019,Nov
2019-11,Wisconsin,8109,15182,18344,1020,34546,2019,Nov
2019-11,Wyoming,251,2094,2425,169,4688,2019,Nov
2019-10,Alabama,25615,16759,13692,1078,31529,2019,Oct
2019-10,Alaska,168,3304,3510,392,7206,2019,Oct
2019-10,Arizona,5151,11543,7509,1138,20190,2019,Oct
2019-10,Arkansas,3031,4809,7173,351,12333,2019,Oct
2019-10,California,36057,32128,23005,4198,59331,2019,Oct
2019-10,Colorado,6006,15537,13269,1347,30153,2019,Oct
2019-10,Connecticut,5230,4347,1990,502,6839,2019,Oct
2019-10,Delaware,199,1624,1749,116,3489,2019,Oct
2019-10,District of Columbia,814,113,3,0,116,2019,Oct
2019-10,Florida,16293,47504,19816,3830,71150,2019,Oct
2019-10,Georgia,17918,11105,9858,598,21561,2019,Oct
2019-10,Guam,0,125,69,14,208,2019,Oct
2019-10,Hawaii,1099,0,0,0,0,2019,Oct
2019-10,Idaho,8467,3784,5530,375,9689,2019,Oct
2019-10,Illinois,12414,17482,10040,0,27522,2019,Oct
2019-10,Indiana,759,16204,12595,1528,30327,2019,Oct
2019-10,Iowa,5707,174,2940,46,3160,2019,Oct
2019-10,Kansas,1270,4917,5227,480,10624,2019,Oct
2019-10,Kentucky,2238,8759,8890,455,18104,2019,Oct
2019-10,Louisiana,1606,8450,11231,674,20355,2019,Oct
2019-10,Maine,430,2997,5699,294,8990,2019,Oct
2019-10,Mariana Islands,0,11,4,0,15,2019,Oct
2019-10,Maryland,4065,3372,5731,132,9235,2019,Oct
2019-10,Massachusetts,10709,4064,2561,473,7098,2019,Oct
2019-10,Michigan,16577,9550,12790,685,23025,2019,Oct
2019-10,Minnesota,11039,8762,16263,909,25934,2019,Oct
2019-10,Mississippi,2056,6506,7086,369,13961,2019,Oct
2019-10,Missouri,3109,16633,18732,1646,37011,2019,Oct
2019-10,Montana,1355,2612,5541,251,8404,2019,Oct
2019-10,Nebraska,3365,81,2182,21,2284,2019,Oct
2019-10,Nevada,2454,4402,2573,298,7273,2019,Oct
2019-10,New Hampshire,1294,4876,3219,216,8311,2019,Oct
2019-10,New Jersey,0,3756,3226,229,7211,2019,Oct
2019-10,New Mexico,809,5518,3964,512,9994,2019,Oct
2019-10,New York,3504,8810,16600,1272,26682,2019,Oct
2019-10,North Carolina,22917,1370,12811,1014,15195,2019,Oct
2019-10,North Dakota,297,1446,3638,143,5227,2019,Oct
2019-10,Ohio,10826,18896,16127,1706,36729,2019,Oct
2019-10,Oklahoma,3398,10536,9256,1064,20856,2019,Oct
2019-10,Oregon,5238,13377,10705,0,24082,2019,Oct
2019-10,Pennsylvania,23379,44371,17094,54,61519,2019,Oct
2019-10,Puerto Rico,0,1892,161,79,2132,2019,Oct
2019-10,Rhode Island,0,942,698,66,1706,2019,Oct
2019-10,South Carolina,8427,8542,6648,623,15813,2019,Oct
2019-10,South Dakota,579,2216,5161,215,7592,2019,Oct
2019-10,Tennessee,5513,21973,15268,1342,38583,2019,Oct
2019-10,Texas,28826,41994,33957,3423,79374,2019,Oct
2019-10,Utah,11721,2898,3819,312,7029,2019,Oct
2019-10,Vermont,0,1283,1860,103,3246,2019,Oct
2019-10,Virgin Islands,128,21,1,0,22,2019,Oct
2019-10,Virginia,497,20887,15388,3146,39421,2019,Oct
2019-10,Washington,13310,13948,9851,2574,26373,2019,Oct
2019-10,West Virginia,3309,5026,6883,274,12183,2019,Oct
2019-10,Wisconsin,8506,13148,15376,1028,29552,2019,Oct
2019-10,Wyoming,479,1594,2368,142,4104,2019,Oct
2019-09,Alabama,23674,14259,12550,1100,27909,2019,Sep
2019-09,Alaska,200,2276,2766,291,5333,2019,Sep
2019-09,Arizona,4812,12126,7629,1441,21196,2019,Sep
2019-09,Arkansas,2995,4535,5063,392,9990,2019,Sep
2019-09,California,37637,30776,22726,3524,57026,2019,Sep
2019-09,Colorado,5583,14614,12289,1520,28423,2019,Sep
2019-09,Connecticut,5507,4115,1726,577,6418,2019,Sep
2019-09,Delaware,207,1397,1378,134,2909,2019,Sep
2019-09,District of Columbia,484,94,5,0,99,2019,Sep
2019-09,Florida,14077,44565,18261,4154,66980,2019,Sep
2019-09,Georgia,17501,10415,7843,601,18859,2019,Sep
2019-09,Guam,0,123,58,17,198,2019,Sep
2019-09,Hawaii,967,0,0,0,0,2019,Sep
2019-09,Idaho,5828,3645,4776,395,8816,2019,Sep
2019-09,Illinois,13011,17639,9512,0,27151,2019,Sep
2019-09,Indiana,504,15291,10734,1680,27705,2019,Sep
2019-09,Iowa,4288,131,2288,31,2450,2019,Sep
2019-09,Kansas,1048,4405,4322,477,9204,2019,Sep
2019-09,Kentucky,1675,8526,6502,489,15517,2019,Sep
2019-09,Louisiana,1784,8996,9417,786,19199,2019,Sep
2019-09,Maine,441,2919,4439,265,7623,2019,Sep
2019-09,Mariana Islands,0,6,10,0,16,2019,Sep
2019-09,Maryland,3189,2981,4714,131,7826,2019,Sep
2019-09,Massachusetts,10377,3523,2370,468,6361,2019,Sep
2019-09,Michigan,15531,9135,11241,767,21143,2019,Sep
2019-09,Minnesota,10138,8131,14379,870,23380,2019,Sep
2019-09,Mississippi,1691,6384,5653,380,12417,2019,Sep
2019-09,Missouri,2953,15032,13663,1559,30254,2019,Sep
2019-09,Montana,1129,2651,4533,270,7454,2019,Sep
2019-09,Nebraska,3234,63,1631,23,1717,2019,Sep
2019-09,Nevada,1826,3985,2467,297,6749,2019,Sep
2019-09,New Hampshire,1192,4458,2948,190,7596,2019,Sep
2019-09,New Jersey,0,3760,3285,218,7263,2019,Sep
2019-09,New Mexico,737,5517,3752,601,9870,2019,Sep
2019-09,New York,3219,8316,16334,1417,26067,2019,Sep
2019-09,North Carolina,21099,1306,10756,941,13003,2019,Sep
2019-09,North Dakota,227,1489,3300,134,4923,2019,Sep
2019-09,Ohio,10321,17083,13048,1534,31665,2019,Sep
2019-09,Oklahoma,3284,8852,7851,1127,17830,2019,Sep
2019-09,Oregon,4537,12140,10443,0,22583,2019,Sep
2019-09,Pennsylvania,21942,40203,14471,33,54707,2019,Sep
2019-09,Puerto Rico,0,1554,191,85,1830,2019,Sep
2019-09,Rhode Island,0,837,649,74,1560,2019,Sep
2019-09,South Carolina,7673,7420,5455,689,13564,2019,Sep
2019-09,South Dakota,583,2068,3640,168,5876,2019,Sep
2019-09,Tennessee,4246,20638,13292,1314,35244,2019,Sep
2019-09,Texas,27236,42688,35840,3736,82264,2019,Sep
2019-09,Utah,8999,2892,3430,322,6644,2019,Sep
2019-09,Vermont,0,1175,1559,154,2888,2019,Sep
2019-09,Virgin Islands,89,26,2,0,28,2019,Sep
2019-09,Virginia,573,19517,13336,3231,36084,2019,Sep
2019-09,Washington,11495,12977,8424,2581,23982,2019,Sep
2019-09,West Virginia,5232,4581,5149,339,10069,2019,Sep
2019-09,Wisconsin,7833,12339,13865,980,27184,2019,Sep
2019-09,Wyoming,669,1595,2274,147,4016,2019,Sep
2019-08,Alabama,29437,18831,12672,1379,32882,2019,Aug
2019-08,Alaska,51,2593,3137,319,6049,2019,Aug
2019-08,Arizona,6095,14272,8281,1495,24048,2019,Aug
2019-08,Arkansas,3397,5267,5445,386,11098,2019,Aug
2019-08,California,26631,36607,25247,3837,65691,2019,Aug
2019-08,Colorado,6188,17237,12352,1522,31111,2019,Aug
2019-08,Connecticut,5606,4806,1785,712,7303,2019,Aug
2019-08,Delaware,167,1630,1383,133,3146,2019,Aug
2019-08,District of Columbia,228,101,5,0,106,2019,Aug
2019-08,Florida,19468,54215,18910,4711,77836,2019,Aug
2019-08,Georgia,20151,12501,8234,711,21446,2019,Aug
2019-08,Guam,0,128,95,18,241,2019,Aug
2019-08,Hawaii,1021,0,0,0,0,2019,Aug
2019-08,Idaho,6159,4039,4604,403,9046,2019,Aug
2019-08,Illinois,13542,19105,9281,0,28386,2019,Aug
2019-08,Indiana,1140,19883,11389,1756,33028,2019,Aug
2019-08,Iowa,4674,144,1985,32,2161,2019,Aug
2019-08,Kansas,1281,5240,4730,509,10479,2019,Aug
2019-08,Kentucky,1628,10802,6592,475,17869,2019,Aug
2019-08,Louisiana,1959,10016,8147,892,19055,2019,Aug
2019-08,Maine,462,3054,3398,307,6759,2019,Aug
2019-08,Mariana Islands,0,4,4,0,8,2019,Aug
2019-08,Maryland,3364,3518,4472,126,8116,2019,Aug
2019-08,Massachusetts,10965,4788,2609,461,7858,2019,Aug
2019-08,Michigan,18954,9724,8698,706,19128,2019,Aug
2019-08,Minnesota,10745,8510,11265,914,20689,2019,Aug
2019-08,Mississippi,1669,9042,7144,492,16678,2019,Aug
2019-08,Missouri,2895,18605,14755,1809,35169,2019,Aug
2019-08,Montana,1255,2945,3956,270,7171,2019,Aug
2019-08,Nebraska,3507,91,1600,25,1716,2019,Aug
2019-08,Nevada,2086,4896,2596,385,7877,2019,Aug
2019-08,New Hampshire,1318,5168,2744,225,8137,2019,Aug
2019-08,New Jersey,0,4061,3341,196,7598,2019,Aug
2019-08,New Mexico,891,6932,4000,597,11529,2019,Aug
2019-08,New York,2796,7995,11563,1224,20782,2019,Aug
2019-08,North Carolina,24648,1724,11474,1225,14423,2019,Aug
2019-08,North Dakota,298,1656,2792,154,4602,2019,Aug
2019-08,Ohio,11005,22222,12658,1901,36781,2019,Aug
2019-08,Oklahoma,3837,10823,8668,1266,20757,2019,Aug
2019-08,Oregon,4885,13926,9496,0,23422,2019,Aug
2019-08,Pennsylvania,25460,43559,13314,45,56918,2019,Aug
2019-08,Puerto Rico,0,2135,233,67,2435,2019,Aug
2019-08,Rhode Island,0,954,618,80,1652,2019,Aug
2019-08,South Carolina,8337,9423,6241,833,16497,2019,Aug
2019-08,South Dakota,553,2367,3343,195,5905,2019,Aug
2019-08,Tennessee,4256,25754,14536,1540,41830,2019,Aug
2019-08,Texas,29242,49804,36943,3855,90602,2019,Aug
2019-08,Utah,10682,2976,3002,340,6318,2019,Aug
2019-08,Vermont,0,1371,1320,156,2847,2019,Aug
2019-08,Virgin Islands,125,21,3,0,24,2019,Aug
2019-08,Virginia,946,23429,13458,3324,40211,2019,Aug
2019-08,Washington,13289,13689,7551,2632,23872,2019,Aug
2019-08,West Virginia,2748,5846,4737,339,10922,2019,Aug
2019-08,Wisconsin,8235,13127,11622,1009,25758,2019,Aug
2019-08,Wyoming,288,1767,2004,166,3937,2019,Aug
2019-07,Alabama,33116,8711,5851,410,14972,2019,Jul
2019-07,Alaska,167,2172,2139,247,4558,2019,Jul
2019-07,Arizona,5181,11005,5995,1203,18203,2019,Jul
2019-07,Arkansas,2687,4049,3487,289,7825,2019,Jul
2019-07,California,27930,30400,20830,3485,54715,2019,Jul
2019-07,Colorado,6156,15550,9601,1238,26389,2019,Jul
2019-07,Connecticut,6838,4235,1403,409,6047,2019,Jul
2019-07,Delaware,227,1410,936,107,2453,2019,Jul
2019-07,District of Columbia,250,105,4,0,109,2019,Jul
2019-07,Florida,14674,43914,13570,3307,60791,2019,Jul
2019-07,Georgia,16348,9663,5261,476,15400,2019,Jul
2019-07,Guam,0,121,57,14,192,2019,Jul
2019-07,Hawaii,1040,0,0,0,0,2019,Jul
2019-07,Idaho,11449,3504,3341,311,7156,2019,Jul
2019-07,Illinois,10764,15782,6889,0,22671,2019,Jul
2019-07,Indiana,534,13982,7568,1225,22775,2019,Jul
2019-07,Iowa,3935,113,1264,29,1406,2019,Jul
2019-07,Kansas,1635,4255,3203,417,7875,2019,Jul
2019-07,Kentucky,1627,8059,4658,370,13087,2019,Jul
2019-07,Louisiana,1781,7646,5110,624,13380,2019,Jul
2019-07,Maine,412,2322,2161,190,4673,2019,Jul
2019-07,Mariana Islands,0,5,8,0,13,2019,Jul
2019-07,Maryland,3248,3082,3162,84,6328,2019,Jul
2019-07,Massachusetts,9084,3711,1886,387,5984,2019,Jul
2019-07,Michigan,17643,7396,5571,538,13505,2019,Jul
2019-07,Minnesota,7939,6938,6575,610,14123,2019,Jul
2019-07,Mississippi,1694,5769,3476,313,9558,2019,Jul
2019-07,Missouri,2602,14131,10224,1249,25604,2019,Jul
2019-07,Montana,1018,2615,3045,192,5852,2019,Jul
2019-07,Nebraska,2736,80,1047,19,1146,2019,Jul
2019-07,Nevada,1917,3852,1891,313,6056,2019,Jul
2019-07,New Hampshire,1169,3874,1996,217,6087,2019,Jul
2019-07,New Jersey,0,4160,2590,211,6961,2019,Jul
2019-07,New Mexico,777,5219,3365,458,9042,2019,Jul
2019-07,New York,3060,7051,8051,1055,16157,2019,Jul
2019-07,North Carolina,22769,1265,7650,806,9721,2019,Jul
2019-07,North Dakota,302,1219,1942,111,3272,2019,Jul
2019-07,Ohio,10259,15931,9342,1203,26476,2019,Jul
2019-07,Oklahoma,3249,8752,5997,923,15672,2019,Jul
2019-07,Oregon,4178,11746,7572,0,19318,2019,Jul
2019-07,Pennsylvania,21201,33850,10017,27,43894,2019,Jul
2019-07,Puerto Rico,0,1958,192,119,2269,2019,Jul
2019-07,Rhode Island,0,788,479,73,1340,2019,Jul
2019-07,South Carolina,8181,7274,3667,696,11637,2019,Jul
2019-07,South Dakota,478,2057,2214,159,4430,2019,Jul
2019-07,Tennessee,12773,19494,10191,1116,30801,2019,Jul
2019-07,Texas,21477,34215,21520,3002,58737,2019,Jul
2019-07,Utah,14092,2558,2495,269,5322,2019,Jul
2019-07,Vermont,0,1005,978,122,2105,2019,Jul
2019-07,Virgin Islands,25,45,5,0,50,2019,Jul
2019-07,Virginia,670,19139,9731,2757,31627,2019,Jul
2019-07,Washington,13468,12636,5788,2716,21140,2019,Jul
2019-07,West Virginia,1951,4289,3610,229,8128,2019,Jul
2019-07,Wisconsin,6733,9938,6714,746,17398,2019,Jul
2019-07,Wyoming,790,1528,1587,136,3251,2019,Jul
2019-06,Alabama,28449,6947,4521,298,11766,2019,Jun
2019-06,Alaska,251,2465,2000,239,4704,2019,Jun
2019-06,Arizona,5371,11375,5931,1309,18615,2019,Jun
2019-06,Arkansas,2690,4653,3214,292,8159,2019,Jun
2019-06,California,39303,38712,27050,4856,70618,2019,Jun
2019-06,Colorado,5983,16013,10215,1360,27588,2019,Jun
2019-06,Connecticut,7368,4296,1449,533,6278,2019,Jun
2019-06,Delaware,610,1364,907,122,2393,2019,Jun
2019-06,District of Columbia,172,113,3,0,116,2019,Jun
2019-06,Florida,15427,44378,13576,3642,61596,2019,Jun
2019-06,Georgia,14858,10549,5425,566,16540,2019,Jun
2019-06,Guam,0,123,46,8,177,2019,Jun
2019-06,Hawaii,856,0,0,0,0,2019,Jun
2019-06,Idaho,8977,3599,3611,367,7577,2019,Jun
2019-06,Illinois,12246,17041,7321,0,24362,2019,Jun
2019-06,Indiana,168,15272,7963,1368,24603,2019,Jun
2019-06,Iowa,3669,117,1299,20,1436,2019,Jun
2019-06,Kansas,1860,4133,2981,453,7567,2019,Jun
2019-06,Kentucky,150731,8520,4608,384,13512,2019,Jun
2019-06,Louisiana,1870,7874,4613,673,13160,2019,Jun
2019-06,Maine,497,2616,2091,236,4943,2019,Jun
2019-06,Mariana Islands,0,8,9,1,18,2019,Jun
2019-06,Maryland,2956,3097,3377,98,6572,2019,Jun
2019-06,Massachusetts,9618,4203,1808,406,6417,2019,Jun
2019-06,Michigan,17211,8445,5628,589,14662,2019,Jun
2019-06,Minnesota,8929,7316,6337,747,14400,2019,Jun
2019-06,Mississippi,1603,5883,3303,286,9472,2019,Jun
2019-06,Missouri,2400,14970,10263,1443,26676,2019,Jun
2019-06,Montana,1042,2644,3130,216,5990,2019,Jun
2019-06,Nebraska,3085,109,1089,16,1214,2019,Jun
2019-06,Nevada,2056,4117,2066,306,6489,2019,Jun
2019-06,New Hampshire,1175,4138,2310,169,6617,2019,Jun
2019-06,New Jersey,0,4273,2652,178,7103,2019,Jun
2019-06,New Mexico,873,5389,3203,530,9122,2019,Jun
2019-06,New York,2954,7400,9047,1092,17539,2019,Jun
2019-06,North Carolina,20392,1411,7908,894,10213,2019,Jun
2019-06,North Dakota,284,1286,1942,114,3342,2019,Jun
2019-06,Ohio,10121,17949,9885,1659,29493,2019,Jun
2019-06,Oklahoma,3204,9630,5819,1026,16475,2019,Jun
2019-06,Oregon,4341,12046,8124,0,20170,2019,Jun
2019-06,Pennsylvania,19159,36023,10325,27,46375,2019,Jun
2019-06,Puerto Rico,0,2568,193,117,2878,2019,Jun
2019-06,Rhode Island,0,787,499,76,1362,2019,Jun
2019-06,South Carolina,8068,8236,3834,740,12810,2019,Jun
2019-06,South Dakota,555,2162,2237,166,4565,2019,Jun
2019-06,Tennessee,12748,20708,9777,1510,31995,2019,Jun
2019-06,Texas,25136,37592,22608,3351,63551,2019,Jun
2019-06,Utah,10927,2803,2571,273,5647,2019,Jun
2019-06,Vermont,0,1116,982,101,2199,2019,Jun
2019-06,Virgin Islands,62,38,7,0,45,2019,Jun
2019-06,Virginia,994,20006,9518,2825,32349,2019,Jun
2019-06,Washington,14966,28670,18920,12059,59649,2019,Jun
2019-06,West Virginia,1982,4894,3738,302,8934,2019,Jun
2019-06,Wisconsin,8041,11174,7388,854,19416,2019,Jun
2019-06,Wyoming,429,1664,1728,160,3552,2019,Jun
2019-05,Alabama,30221,6448,4041,271,10760,2019,May
2019-05,Alaska,264,2716,2440,287,5443,2019,May
2019-05,Arizona,6745,11969,5987,1242,19198,2019,May
2019-05,Arkansas,3582,4600,3499,293,8392,2019,May
2019-05,California,45237,36314,24718,4700,65732,2019,May
2019-05,Colorado,6697,16653,10619,1445,28717,2019,May
2019-05,Connecticut,7367,4655,1622,654,6931,2019,May
2019-05,Delaware,642,1568,1028,159,2755,2019,May
2019-05,District of Columbia,244,142,4,0,146,2019,May
2019-05,Florida,16117,45087,14214,3760,63061,2019,May
2019-05,Georgia,17365,10988,5172,558,16718,2019,May
2019-05,Guam,0,102,46,11,159,2019,May
2019-05,Hawaii,1100,0,0,0,0,2019,May
2019-05,Idaho,8651,3738,3728,359,7825,2019,May
2019-05,Illinois,13168,17976,7587,0,25563,2019,May
2019-05,Indiana,110,15062,8146,1431,24639,2019,May
2019-05,Iowa,4762,115,1471,27,1613,2019,May
2019-05,Kansas,1915,4466,3391,462,8319,2019,May
2019-05,Kentucky,315756,7899,4585,343,12827,2019,May
2019-05,Louisiana,2565,8327,5074,724,14125,2019,May
2019-05,Maine,576,2886,2285,331,5502,2019,May
2019-05,Mariana Islands,0,7,7,2,16,2019,May
2019-05,Maryland,3475,3385,3645,89,7119,2019,May
2019-05,Massachusetts,11447,3759,2113,437,6309,2019,May
2019-05,Michigan,19176,9057,5984,602,15643,2019,May
2019-05,Minnesota,11487,8570,7754,809,17133,2019,May
2019-05,Mississippi,1613,6614,3553,353,10520,2019,May
2019-05,Missouri,2492,15869,10448,1452,27769,2019,May
2019-05,Montana,1091,2747,3255,222,6224,2019,May
2019-05,Nebraska,3146,67,1089,22,1178,2019,May
2019-05,Nevada,2535,4128,2161,281,6570,2019,May
2019-05,New Hampshire,1291,4079,2328,205,6612,2019,May
2019-05,New Jersey,0,4791,2545,219,7555,2019,May
2019-05,New Mexico,1286,5564,3361,530,9455,2019,May
2019-05,New York,3240,8260,10090,1296,19646,2019,May
2019-05,North Carolina,24202,1312,7798,989,10099,2019,May
2019-05,North Dakota,468,1436,2033,106,3575,2019,May
2019-05,Ohio,12245,17577,9758,1569,28904,2019,May
2019-05,Oklahoma,3048,9704,6112,1055,16871,2019,May
2019-05,Oregon,5465,12305,8465,0,20770,2019,May
2019-05,Pennsylvania,22289,38050,10807,13,48870,2019,May
2019-05,Puerto Rico,0,2266,188,153,2607,2019,May
2019-05,Rhode Island,0,941,515,96,1552,2019,May
2019-05,South Carolina,9850,8332,3531,843,12706,2019,May
2019-05,South Dakota,650,2148,2383,187,4718,2019,May
2019-05,Tennessee,12526,20921,9885,1522,32328,2019,May
2019-05,Texas,28928,38714,23587,3118,65419,2019,May
2019-05,Utah,19931,3045,2849,289,6183,2019,May
2019-05,Vermont,0,1333,1138,111,2582,2019,May
2019-05,Virgin Islands,60,27,4,0,31,2019,May
2019-05,Virginia,1205,17935,8821,2454,29210,2019,May
2019-05,Washington,13988,18141,11217,4250,33608,2019,May
2019-05,West Virginia,2223,4787,3700,278,8765,2019,May
2019-05,Wisconsin,7840,11997,8512,948,21457,2019,May
2019-05,Wyoming,639,1740,1828,150,3718,2019,May
2019-04,Alabama,26958,6747,4538,265,11550,2019,Apr
2019-04,Alaska,243,2704,2605,323,5632,2019,Apr
2019-04,Arizona,6120,12985,6750,1280,21015,2019,Apr
2019-04,Arkansas,3373,4951,4060,319,9330,2019,Apr
2019-04,California,46004,37484,25895,4204,67583,2019,Apr
2019-04,Colorado,7612,17199,11594,1470,30263,2019,Apr
2019-04,Connecticut,8167,4775,1792,500,7067,2019,Apr
2019-04,Delaware,519,1687,1146,132,2965,2019,Apr
2019-04,District of Columbia,282,122,1,0,123,2019,Apr
2019-04,Florida,18613,48329,15125,3652,67106,2019,Apr
2019-04,Georgia,19573,12049,5798,608,18455,2019,Apr
2019-04,Guam,0,88,46,11,145,2019,Apr
2019-04,Hawaii,1207,0,0,0,0,2019,Apr
2019-04,Idaho,6608,3865,4118,379,8362,2019,Apr
2019-04,Illinois,14158,21307,8748,0,30055,2019,Apr
2019-04,Indiana,41080,18528,9718,1493,29739,2019,Apr
2019-04,Iowa,5933,200,1761,41,2002,2019,Apr
2019-04,Kansas,1739,4737,3858,433,9028,2019,Apr
2019-04,Kentucky,361715,10133,5989,390,16512,2019,Apr
2019-04,Louisiana,2285,9196,5330,709,15235,2019,Apr
2019-04,Maine,652,3134,2819,327,6280,2019,Apr
2019-04,Mariana Islands,0,6,6,0,12,2019,Apr
2019-04,Maryland,3839,3759,4478,120,8357,2019,Apr
2019-04,Massachusetts,10866,3846,2280,455,6581,2019,Apr
2019-04,Michigan,21511,10368,7277,798,18443,2019,Apr
2019-04,Minnesota,15173,10655,11570,1007,23232,2019,Apr
2019-04,Mississippi,1831,7199,3936,341,11476,2019,Apr
2019-04,Missouri,2835,15972,12020,1478,29470,2019,Apr
2019-04,Montana,1417,2815,3704,242,6761,2019,Apr
2019-04,Nebraska,3650,84,1318,20,1422,2019,Apr
2019-04,Nevada,2524,4502,2535,315,7352,2019,Apr
2019-04,New Hampshire,1312,4747,2873,207,7827,2019,Apr
2019-04,New Jersey,0,4819,2982,213,8014,2019,Apr
2019-04,New Mexico,943,5808,3936,609,10353,2019,Apr
2019-04,New York,3926,8971,12724,1521,23216,2019,Apr
2019-04,North Carolina,27292,1487,8892,980,11359,2019,Apr
2019-04,North Dakota,438,1743,2524,131,4398,2019,Apr
2019-04,Ohio,14338,22541,11994,2104,36639,2019,Apr
2019-04,Oklahoma,3558,10608,7199,1334,19141,2019,Apr
2019-04,Oregon,6320,13360,9875,0,23235,2019,Apr
2019-04,Pennsylvania,24075,42418,12300,32,54750,2019,Apr
2019-04,Puerto Rico,0,2135,162,91,2388,2019,Apr
2019-04,Rhode Island,0,995,742,115,1852,2019,Apr
2019-04,South Carolina,8347,9362,4050,702,14114,2019,Apr
2019-04,South Dakota,706,2360,2870,193,5423,2019,Apr
2019-04,Tennessee,14849,21848,10619,1224,33691,2019,Apr
2019-04,Texas,28638,38994,24009,3451,66454,2019,Apr
2019-04,Utah,16689,3365,3235,361,6961,2019,Apr
2019-04,Vermont,0,1518,1485,122,3125,2019,Apr
2019-04,Virgin Islands,82,24,5,1,30,2019,Apr
2019-04,Virginia,1262,20270,10699,2692,33661,2019,Apr
2019-04,Washington,16452,17631,10844,3139,31614,2019,Apr
2019-04,West Virginia,2635,5819,4822,318,10959,2019,Apr
2019-04,Wisconsin,9159,14617,12535,1127,28279,2019,Apr
2019-04,Wyoming,459,1888,1906,153,3947,2019,Apr
2019-03,Alabama,31811,9991,6439,348,16778,2019,Mar
2019-03,Alaska,173,3117,2844,355,6316,2019,Mar
2019-03,Arizona,7564,15993,8497,1422,25912,2019,Mar
2019-03,Arkansas,3605,7948,5821,467,14236,2019,Mar
2019-03,California,46812,42551,28146,4299,74996,2019,Mar
2019-03,Colorado,7183,22511,13791,1720,38022,2019,Mar
2019-03,Connecticut,8604,6189,2344,789,9322,2019,Mar
2019-03,Delaware,647,2407,1377,170,3954,2019,Mar
2019-03,District of Columbia,300,112,5,0,117,2019,Mar
2019-03,Florida,21078,59615,19429,3869,82913,2019,Mar
2019-03,Georgia,23338,19228,9131,784,29143,2019,Mar
2019-03,Guam,0,123,53,13,189,2019,Mar
2019-03,Hawaii,1126,0,0,0,0,2019,Mar
2019-03,Idaho,5908,5362,5161,502,11025,2019,Mar
2019-03,Illinois,18595,29438,13143,0,42581,2019,Mar
2019-03,Indiana,44867,26630,13737,2005,42372,2019,Mar
2019-03,Iowa,6953,204,3014,55,3273,2019,Mar
2019-03,Kansas,1688,7807,5590,693,14090,2019,Mar
2019-03,Kentucky,350354,15646,8110,534,24290,2019,Mar
2019-03,Louisiana,2106,13050,7148,892,21090,2019,Mar
2019-03,Maine,703,4191,2992,380,7563,2019,Mar
2019-03,Mariana Islands,0,8,8,2,18,2019,Mar
2019-03,Maryland,4123,4288,6080,138,10506,2019,Mar
2019-03,Massachusetts,11470,5079,3151,644,8874,2019,Mar
2019-03,Michigan,24361,15403,10260,903,26566,2019,Mar
2019-03,Minnesota,14888,12098,11981,1307,25386,2019,Mar
2019-03,Mississippi,1963,11180,6116,430,17726,2019,Mar
2019-03,Missouri,3000,23939,17749,2160,43848,2019,Mar
2019-03,Montana,1290,3703,4218,351,8272,2019,Mar
2019-03,Nebraska,4576,146,1913,27,2086,2019,Mar
2019-03,Nevada,2657,6661,3114,446,10221,2019,Mar
2019-03,New Hampshire,1508,6297,3374,254,9925,2019,Mar
2019-03,New Jersey,0,4579,3446,226,8251,2019,Mar
2019-03,New Mexico,881,8137,5252,784,14173,2019,Mar
2019-03,New York,3949,10834,14996,1751,27581,2019,Mar
2019-03,North Carolina,32987,1931,12758,1249,15938,2019,Mar
2019-03,North Dakota,514,2191,2783,158,5132,2019,Mar
2019-03,Ohio,16273,31090,17313,2208,50611,2019,Mar
2019-03,Oklahoma,3941,15423,9896,1416,26735,2019,Mar
2019-03,Oregon,5960,17208,12161,0,29369,2019,Mar
2019-03,Pennsylvania,27864,60068,16921,29,77018,2019,Mar
2019-03,Puerto Rico,0,2238,157,98,2493,2019,Mar
2019-03,Rhode Island,0,1201,858,159,2218,2019,Mar
2019-03,South Carolina,9467,13957,6268,843,21068,2019,Mar
2019-03,South Dakota,682,3274,3450,228,6952,2019,Mar
2019-03,Tennessee,19094,30728,15086,1463,47277,2019,Mar
2019-03,Texas,34837,55222,31747,4092,91061,2019,Mar
2019-03,Utah,18552,4876,4081,393,9350,2019,Mar
2019-03,Vermont,0,2043,1693,220,3956,2019,Mar
2019-03,Virgin Islands,109,28,3,0,31,2019,Mar
2019-03,Virginia,1221,29043,14550,3547,47140,2019,Mar
2019-03,Washington,18082,21158,13211,3329,37698,2019,Mar
2019-03,West Virginia,2939,8633,6778,469,15880,2019,Mar
2019-03,Wisconsin,9950,19952,15240,1283,36475,2019,Mar
2019-03,Wyoming,338,2497,2314,199,5010,2019,Mar
2019-02,Alabama,28831,8278,5353,302,13933,2019,Feb
2019-02,Alaska,189,2261,1904,276,4441,2019,Feb
2019-02,Arizona,6444,13933,7135,1244,22312,2019,Feb
2019-02,Arkansas,2930,7144,5251,357,12752,2019,Feb
2019-02,California,33102,36424,22506,3932,62862,2019,Feb
2019-02,Colorado,6987,18697,11731,1550,31978,2019,Feb
2019-02,Connecticut,6697,5459,1818,654,7931,2019,Feb
2019-02,Delaware,418,1698,1208,124,3030,2019,Feb
2019-02,District of Columbia,267,88,4,0,92,2019,Feb
2019-02,Florida,18437,51711,17833,3649,73193,2019,Feb
2019-02,Georgia,19711,16172,7742,680,24594,2019,Feb
2019-02,Guam,0,113,51,10,174,2019,Feb
2019-02,Hawaii,1028,0,0,0,0,2019,Feb
2019-02,Idaho,7835,3887,3548,394,7829,2019,Feb
2019-02,Illinois,14499,24870,11381,0,36251,2019,Feb
2019-02,Indiana,29574,21297,11157,1623,34077,2019,Feb
2019-02,Iowa,5491,153,1935,60,2148,2019,Feb
2019-02,Kansas,1909,6271,4688,593,11552,2019,Feb
2019-02,Kentucky,303739,12027,7182,443,19652,2019,Feb
2019-02,Louisiana,2491,11056,6849,727,18632,2019,Feb
2019-02,Maine,673,2989,2352,308,5649,2019,Feb
2019-02,Mariana Islands,0,10,7,1,18,2019,Feb
2019-02,Maryland,3183,3822,4613,124,8559,2019,Feb
2019-02,Massachusetts,11007,4359,2428,555,7342,2019,Feb
2019-02,Michigan,18930,11272,7497,702,19471,2019,Feb
2019-02,Minnesota,9567,7938,7215,889,16042,2019,Feb
2019-02,Mississippi,1845,9790,5717,393,15900,2019,Feb
2019-02,Missouri,2326,19884,13773,1688,35345,2019,Feb
2019-02,Montana,1167,2391,2730,254,5375,2019,Feb
2019-02,Nebraska,4029,122,1428,26,1576,2019,Feb
2019-02,Nevada,2366,5541,2524,353,8418,2019,Feb
2019-02,New Hampshire,1301,5793,2713,230,8736,2019,Feb
2019-02,New Jersey,0,3794,2949,174,6917,2019,Feb
2019-02,New Mexico,814,6890,4371,673,11934,2019,Feb
2019-02,New York,2767,8914,11566,1726,22206,2019,Feb
2019-02,North Carolina,29866,1620,11335,1083,14038,2019,Feb
2019-02,North Dakota,461,1514,1981,131,3626,2019,Feb
2019-02,Ohio,12403,25652,13985,1635,41272,2019,Feb
2019-02,Oklahoma,4255,13014,8165,1318,22497,2019,Feb
2019-02,Oregon,4543,14214,9428,0,23642,2019,Feb
2019-02,Pennsylvania,22785,47570,13297,17,60884,2019,Feb
2019-02,Puerto Rico,0,2129,154,83,2366,2019,Feb
2019-02,Rhode Island,0,1043,624,134,1801,2019,Feb
2019-02,South Carolina,7749,12375,5724,760,18859,2019,Feb
2019-02,South Dakota,663,2701,2790,243,5734,2019,Feb
2019-02,Tennessee,19935,27213,14058,1500,42771,2019,Feb
2019-02,Texas,37469,49130,28709,3663,81502,2019,Feb
2019-02,Utah,14151,3463,3018,317,6798,2019,Feb
2019-02,Vermont,0,1545,1373,163,3081,2019,Feb
2019-02,Virgin Islands,72,46,1,1,48,2019,Feb
2019-02,Virginia,1094,24579,12572,3168,40319,2019,Feb
2019-02,Washington,13583,15775,10106,2927,28808,2019,Feb
2019-02,West Virginia,2455,7011,5575,384,12970,2019,Feb
2019-02,Wisconsin,8810,13838,9899,1017,24754,2019,Feb
2019-02,Wyoming,439,1900,1791,168,3859,2019,Feb
2019-01,Alabama,29977,6671,5507,343,12521,2019,Jan
2019-01,Alaska,249,1877,1685,290,3852,2019,Jan
2019-01,Arizona,6004,11710,6865,1255,19830,2019,Jan
2019-01,Arkansas,2917,5108,5175,401,10684,2019,Jan
2019-01,California,34585,35861,23195,4035,63091,2019,Jan
2019-01,Colorado,7292,16417,11575,1796,29788,2019,Jan
2019-01,Connecticut,7748,5368,1945,788,8101,2019,Jan
2019-01,Delaware,558,1684,1473,141,3298,2019,Jan
2019-01,District of Columbia,253,101,5,0,106,2019,Jan
2019-01,Florida,18964,47372,18749,3651,69772,2019,Jan
2019-01,Georgia,21575,11780,7535,670,19985,2019,Jan
2019-01,Guam,0,122,42,11,175,2019,Jan
2019-01,Hawaii,1064,0,0,0,0,2019,Jan
2019-01,Idaho,5153,3522,3602,414,7538,2019,Jan
2019-01,Illinois,16976,21587,10082,0,31669,2019,Jan
2019-01,Indiana,107476,17265,10423,1738,29426,2019,Jan
2019-01,Iowa,6401,128,1887,68,2083,2019,Jan
2019-01,Kansas,1982,5269,4584,688,10541,2019,Jan
2019-01,Kentucky,290432,8170,6213,510,14893,2019,Jan
2019-01,Louisiana,2357,8961,7473,844,17278,2019,Jan
2019-01,Maine,862,2652,2333,407,5392,2019,Jan
2019-01,Mariana Islands,0,9,11,4,24,2019,Jan
2019-01,Maryland,2758,4254,4473,100,8827,2019,Jan
2019-01,Massachusetts,12279,4016,2644,574,7234,2019,Jan
2019-01,Michigan,19011,8674,6844,800,16318,2019,Jan
2019-01,Minnesota,11526,8031,7106,1078,16215,2019,Jan
2019-01,Mississippi,1777,6833,5707,371,12911,2019,Jan
2019-01,Missouri,2194,16244,12657,1805,30706,2019,Jan
2019-01,Montana,1206,2097,2753,278,5128,2019,Jan
2019-01,Nebraska,4449,125,1711,32,1868,2019,Jan
2019-01,Nevada,2439,5001,2386,407,7794,2019,Jan
2019-01,New Hampshire,1408,4672,2529,118,7319,2019,Jan
2019-01,New Jersey,0,3508,3084,170,6762,2019,Jan
2019-01,New Mexico,979,4987,3778,657,9422,2019,Jan
2019-01,New York,3838,9271,11257,1804,22332,2019,Jan
2019-01,North Carolina,29088,1409,10951,1148,13508,2019,Jan
2019-01,North Dakota,582,1425,2015,147,3587,2019,Jan
2019-01,Ohio,13134,19573,12290,1648,33511,2019,Jan
2019-01,Oklahoma,4889,10411,8202,1419,20032,2019,Jan
2019-01,Oregon,5296,13630,9117,0,22747,2019,Jan
2019-01,Pennsylvania,24429,40144,11833,7,51984,2019,Jan
2019-01,Puerto Rico,0,2030,156,111,2297,2019,Jan
2019-01,Rhode Island,0,1054,662,96,1812,2019,Jan
2019-01,South Carolina,5528,9696,5459,824,15979,2019,Jan
2019-01,South Dakota,1204,2154,2808,222,5184,2019,Jan
2019-01,Tennessee,20155,22848,13776,1315,37939,2019,Jan
2019-01,Texas,37167,39240,27842,3727,70809,2019,Jan
2019-01,Utah,18110,3017,2834,344,6195,2019,Jan
2019-01,Vermont,0,1124,1092,133,2349,2019,Jan
2019-01,Virgin Islands,84,41,2,0,43,2019,Jan
2019-01,Virginia,1061,20600,12813,3209,36622,2019,Jan
2019-01,Washington,18889,17487,10889,3622,31998,2019,Jan
2019-01,West Virginia,2438,5355,4964,379,10698,2019,Jan
2019-01,Wisconsin,11124,12204,9154,1310,22668,2019,Jan
2019-01,Wyoming,357,1530,1621,175,3326,2019,Jan
2018-12,Alabama,26029,11463,13578,464,25505,2018,Dec
2018-12,Alaska,215,2956,3278,312,6546,2018,Dec
2018-12,Arizona,4732,15533,11436,1451,28420,2018,Dec
2018-12,Arkansas,2498,8138,11736,369,20243,2018,Dec
2018-12,California,30754,40445,34180,3808,78433,2018,Dec
2018-12,Colorado,5636,22627,18734,1874,43235,2018,Dec
2018-12,Connecticut,6433,5904,2506,947,9357,2018,Dec
2018-12,Delaware,179,1932,2503,169,4604,2018,Dec
2018-12,District of Columbia,147,71,4,0,75,2018,Dec
2018-12,Florida,16478,60210,30598,4131,94939,2018,Dec
2018-12,Georgia,16029,19241,18475,842,38558,2018,Dec
2018-12,Guam,0,126,62,13,201,2018,Dec
2018-12,Hawaii,1105,0,0,0,0,2018,Dec
2018-12,Idaho,5793,5667,6949,442,13058,2018,Dec
2018-12,Illinois,12795,26943,15297,0,42240,2018,Dec
2018-12,Indiana,24021,24824,18824,2088,45736,2018,Dec
2018-12,Iowa,6782,262,4392,70,4724,2018,Dec
2018-12,Kansas,1450,7418,8702,695,16815,2018,Dec
2018-12,Kentucky,371756,14189,14309,581,29079,2018,Dec
2018-12,Louisiana,2123,13856,17376,910,32142,2018,Dec
2018-12,Maine,491,3783,4282,377,8442,2018,Dec
2018-12,Mariana Islands,0,3,7,0,10,2018,Dec
2018-12,Maryland,1974,4500,7309,102,11911,2018,Dec
2018-12,Massachusetts,9421,4492,3178,558,8228,2018,Dec
2018-12,Michigan,16890,12897,13972,901,27770,2018,Dec
2018-12,Minnesota,10587,9144,11057,1032,21233,2018,Dec
2018-12,Mississippi,1566,11557,14731,469,26757,2018,Dec
2018-12,Missouri,1949,24730,23584,2058,50372,2018,Dec
2018-12,Montana,993,3744,5291,286,9321,2018,Dec
2018-12,Nebraska,4158,160,3331,33,3524,2018,Dec
2018-12,Nevada,1965,5889,3993,429,10311,2018,Dec
2018-12,New Hampshire,1090,5845,3977,175,9997,2018,Dec
2018-12,New Jersey,0,3432,4099,128,7659,2018,Dec
2018-12,New Mexico,615,6858,6580,695,14133,2018,Dec
2018-12,New York,2584,9675,19234,1733,30642,2018,Dec
2018-12,North Carolina,21349,2367,22327,1265,25959,2018,Dec
2018-12,North Dakota,365,1853,3144,132,5129,2018,Dec
2018-12,Ohio,11684,30746,25012,1863,57621,2018,Dec
2018-12,Oklahoma,3183,15708,16053,1492,33253,2018,Dec
2018-12,Oregon,4319,16985,14374,0,31359,2018,Dec
2018-12,Pennsylvania,22247,54857,20732,18,75607,2018,Dec
2018-12,Puerto Rico,0,2026,215,113,2354,2018,Dec
2018-12,Rhode Island,0,1069,770,99,1938,2018,Dec
2018-12,South Carolina,3258,13465,11856,1084,26405,2018,Dec
2018-12,South Dakota,975,2913,4497,215,7625,2018,Dec
2018-12,Tennessee,12652,34499,26987,1847,63333,2018,Dec
2018-12,Texas,28161,62560,56919,4482,123961,2018,Dec
2018-12,Utah,10806,5369,7214,477,13060,2018,Dec
2018-12,Vermont,0,1620,1871,142,3633,2018,Dec
2018-12,Virgin Islands,87,27,4,1,32,2018,Dec
2018-12,Virginia,1107,26129,22048,3524,51701,2018,Dec
2018-12,Washington,15301,23131,20690,5796,49617,2018,Dec
2018-12,West Virginia,1594,9693,10824,464,20981,2018,Dec
2018-12,Wisconsin,11222,16181,14362,1363,31906,2018,Dec
2018-12,Wyoming,378,2653,3033,166,5852,2018,Dec
2018-11,Alabama,22477,8408,10303,357,19068,2018,Nov
2018-11,Alaska,184,2707,2827,360,5894,2018,Nov
2018-11,Arizona,4537,12412,8886,1139,22437,2018,Nov
2018-11,Arkansas,2739,5739,10196,300,16235,2018,Nov
2018-11,California,33942,36997,30913,3606,71516,2018,Nov
2018-11,Colorado,6330,18926,15702,1547,36175,2018,Nov
2018-11,Connecticut,6103,5078,2331,863,8272,2018,Nov
2018-11,Delaware,176,1578,2082,124,3784,2018,Nov
2018-11,District of Columbia,207,80,3,0,83,2018,Nov
2018-11,Florida,16036,51850,23876,3502,79228,2018,Nov
2018-11,Georgia,16456,13770,13749,654,28173,2018,Nov
2018-11,Guam,0,120,49,15,184,2018,Nov
2018-11,Hawaii,1186,0,0,0,0,2018,Nov
2018-11,Idaho,4223,4077,5851,422,10350,2018,Nov
2018-11,Illinois,14214,22978,14038,0,37016,2018,Nov
2018-11,Indiana,23053,20522,18723,1533,40778,2018,Nov
2018-11,Iowa,6284,303,4319,36,4658,2018,Nov
2018-11,Kansas,1872,5885,7334,459,13678,2018,Nov
2018-11,Kentucky,393953,10506,12670,437,23613,2018,Nov
2018-11,Louisiana,2264,10242,14336,788,25366,2018,Nov
2018-11,Maine,556,2661,3768,313,6742,2018,Nov
2018-11,Mariana Islands,0,5,7,0,12,2018,Nov
2018-11,Maryland,1988,3979,7150,137,11266,2018,Nov
2018-11,Massachusetts,11027,4334,3194,532,8060,2018,Nov
2018-11,Michigan,17114,11474,17534,596,29604,2018,Nov
2018-11,Minnesota,9891,6691,10900,704,18295,2018,Nov
2018-11,Mississippi,1569,7650,11816,379,19845,2018,Nov
2018-11,Missouri,1935,19158,21908,1551,42617,2018,Nov
2018-11,Montana,990,2727,4603,274,7604,2018,Nov
2018-11,Nebraska,3951,198,2964,32,3194,2018,Nov
2018-11,Nevada,1765,4806,3132,349,8287,2018,Nov
2018-11,New Hampshire,1123,5051,3514,95,8660,2018,Nov
2018-11,New Jersey,0,3297,3769,150,7216,2018,Nov
2018-11,New Mexico,958,5731,5331,604,11666,2018,Nov
2018-11,New York,2707,8290,18315,1436,28041,2018,Nov
2018-11,North Carolina,21929,2159,18381,927,21467,2018,Nov
2018-11,North Dakota,463,1655,3274,147,5076,2018,Nov
2018-11,Ohio,12779,25372,26274,1615,53261,2018,Nov
2018-11,Oklahoma,3635,12669,14074,1240,27983,2018,Nov
2018-11,Oregon,4518,14426,12344,0,26770,2018,Nov
2018-11,Pennsylvania,22376,49328,20463,24,69815,2018,Nov
2018-11,Puerto Rico,0,2611,227,130,2968,2018,Nov
2018-11,Rhode Island,0,1020,727,121,1868,2018,Nov
2018-11,South Carolina,3681,10229,9329,891,20449,2018,Nov
2018-11,South Dakota,1139,2637,4907,216,7760,2018,Nov
2018-11,Tennessee,19447,27015,22267,2998,52280,2018,Nov
2018-11,Texas,29090,44763,43276,3437,91476,2018,Nov
2018-11,Utah,10423,3989,5599,325,9913,2018,Nov
2018-11,Vermont,0,1094,1690,120,2904,2018,Nov
2018-11,Virgin Islands,66,42,6,0,48,2018,Nov
2018-11,Virginia,1263,22204,19747,3138,45089,2018,Nov
2018-11,Washington,14217,20113,19136,5557,44806,2018,Nov
2018-11,West Virginia,1806,6450,10648,330,17428,2018,Nov
2018-11,Wisconsin,11651,14769,17342,939,33050,2018,Nov
2018-11,Wyoming,369,1933,2532,144,4609,2018,Nov
2018-10,Alabama,23244,5218,5918,229,11365,2018,Oct
2018-10,Alaska,141,3034,3245,327,6606,2018,Oct
2018-10,Arizona,5078,9886,6427,980,17293,2018,Oct
2018-10,Arkansas,4415,4312,6792,220,11324,2018,Oct
2018-10,California,42223,32567,23213,2738,58518,2018,Oct
2018-10,Colorado,7004,15101,13079,1111,29291,2018,Oct
2018-10,Connecticut,6875,4575,1979,635,7189,2018,Oct
2018-10,Delaware,138,1420,1512,92,3024,2018,Oct
2018-10,District of Columbia,116,81,5,0,86,2018,Oct
2018-10,Florida,13921,40226,16671,2912,59809,2018,Oct
2018-10,Georgia,17241,10007,8856,444,19307,2018,Oct
2018-10,Guam,0,120,41,8,169,2018,Oct
2018-10,Hawaii,1201,0,0,0,0,2018,Oct
2018-10,Idaho,7265,3034,5025,255,8314,2018,Oct
2018-10,Illinois,13700,17916,10755,0,28671,2018,Oct
2018-10,Indiana,28925,15032,12352,1151,28535,2018,Oct
2018-10,Iowa,6315,173,2700,23,2896,2018,Oct
2018-10,Kansas,2136,4223,4884,428,9535,2018,Oct
2018-10,Kentucky,394208,7065,8001,360,15426,2018,Oct
2018-10,Louisiana,2014,8073,10567,591,19231,2018,Oct
2018-10,Maine,532,2565,5428,251,8244,2018,Oct
2018-10,Mariana Islands,0,5,7,1,13,2018,Oct
2018-10,Maryland,2240,4020,5112,124,9256,2018,Oct
2018-10,Massachusetts,10864,3750,2632,446,6828,2018,Oct
2018-10,Michigan,19282,8259,11649,508,20416,2018,Oct
2018-10,Minnesota,11735,5041,14232,517,19790,2018,Oct
2018-10,Mississippi,2028,6049,6638,324,13011,2018,Oct
2018-10,Missouri,2328,15963,17163,1320,34446,2018,Oct
2018-10,Montana,1178,2293,5246,189,7728,2018,Oct
2018-10,Nebraska,3780,119,2172,16,2307,2018,Oct
2018-10,Nevada,2236,3731,2051,272,6054,2018,Oct
2018-10,New Hampshire,1232,4238,3494,35,7767,2018,Oct
2018-10,New Jersey,0,3710,2806,158,6674,2018,Oct
2018-10,New Mexico,703,4655,3993,458,9106,2018,Oct
2018-10,New York,3170,8258,16163,1010,25431,2018,Oct
2018-10,North Carolina,20798,1392,12065,724,14181,2018,Oct
2018-10,North Dakota,556,1487,3700,113,5300,2018,Oct
2018-10,Ohio,12733,18401,15830,1139,35370,2018,Oct
2018-10,Oklahoma,4383,8849,8803,919,18571,2018,Oct
2018-10,Oregon,5442,11776,10088,0,21864,2018,Oct
2018-10,Pennsylvania,23850,41412,14583,27,56022,2018,Oct
2018-10,Puerto Rico,0,2419,193,94,2706,2018,Oct
2018-10,Rhode Island,0,947,646,79,1672,2018,Oct
2018-10,South Carolina,5205,7002,6023,596,13621,2018,Oct
2018-10,South Dakota,1258,1882,5208,154,7244,2018,Oct
2018-10,Tennessee,18915,20286,13725,1303,35314,2018,Oct
2018-10,Texas,30568,34646,31100,2972,68718,2018,Oct
2018-10,Utah,11644,2615,3619,269,6503,2018,Oct
2018-10,Vermont,0,1100,1948,107,3155,2018,Oct
2018-10,Virgin Islands,101,39,3,0,42,2018,Oct
2018-10,Virginia,1781,17662,13511,2438,33611,2018,Oct
2018-10,Washington,13545,14925,11932,2387,29244,2018,Oct
2018-10,West Virginia,2113,5250,6998,292,12540,2018,Oct
2018-10,Wisconsin,9121,11766,14833,801,27400,2018,Oct
2018-10,Wyoming,478,1442,2172,102,3716,2018,Oct
2018-09,Alabama,19471,4978,5832,241,11051,2018,Sep
2018-09,Alaska,212,2105,2554,225,4884,2018,Sep
2018-09,Arizona,9651,10298,6638,1096,18032,2018,Sep
2018-09,Arkansas,4265,3987,5257,247,9491,2018,Sep
2018-09,California,34638,29772,23788,2977,56537,2018,Sep
2018-09,Colorado,6491,14546,12061,1022,27629,2018,Sep
2018-09,Connecticut,5777,4151,1782,499,6432,2018,Sep
2018-09,Delaware,154,1187,1225,73,2485,2018,Sep
2018-09,District of Columbia,119,78,4,0,82,2018,Sep
2018-09,Florida,14805,38313,14646,2945,55904,2018,Sep
2018-09,Georgia,14708,10387,7060,476,17923,2018,Sep
2018-09,Guam,0,77,24,11,112,2018,Sep
2018-09,Hawaii,971,0,0,0,0,2018,Sep
2018-09,Idaho,6119,3217,4776,212,8205,2018,Sep
2018-09,Illinois,12726,16749,9393,0,26142,2018,Sep
2018-09,Indiana,25056,13687,10201,1068,24956,2018,Sep
2018-09,Iowa,5640,132,2391,33,2556,2018,Sep
2018-09,Kansas,1380,4043,4326,421,8790,2018,Sep
2018-09,Kentucky,393160,6603,6014,300,12917,2018,Sep
2018-09,Louisiana,3102,8654,9546,699,18899,2018,Sep
2018-09,Maine,518,2678,4102,184,6964,2018,Sep
2018-09,Mariana Islands,0,4,2,2,8,2018,Sep
2018-09,Maryland,1948,3413,4397,100,7910,2018,Sep
2018-09,Massachusetts,9704,3518,2407,393,6318,2018,Sep
2018-09,Michigan,16189,7630,9887,446,17963,2018,Sep
2018-09,Minnesota,24667,3801,10997,359,15157,2018,Sep
2018-09,Mississippi,2074,6470,6042,330,12842,2018,Sep
2018-09,Missouri,1867,15226,12816,1270,29312,2018,Sep
2018-09,Montana,1051,2326,4565,176,7067,2018,Sep
2018-09,Nebraska,2923,83,1547,17,1647,2018,Sep
2018-09,Nevada,1730,3714,2111,284,6109,2018,Sep
2018-09,New Hampshire,1339,4150,3161,163,7474,2018,Sep
2018-09,New Jersey,0,3511,2480,147,6138,2018,Sep
2018-09,New Mexico,891,4596,3985,437,9018,2018,Sep
2018-09,New York,2763,7755,15014,1017,23786,2018,Sep
2018-09,North Carolina,15458,958,8836,700,10494,2018,Sep
2018-09,North Dakota,382,1336,3135,100,4571,2018,Sep
2018-09,Ohio,10640,17460,13312,1110,31882,2018,Sep
2018-09,Oklahoma,1096,8158,7776,921,16855,2018,Sep
2018-09,Oregon,4049,11763,10604,0,22367,2018,Sep
2018-09,Pennsylvania,20170,36793,12563,36,49392,2018,Sep
2018-09,Puerto Rico,0,2155,197,97,2449,2018,Sep
2018-09,Rhode Island,0,738,562,111,1411,2018,Sep
2018-09,South Carolina,6193,6680,4748,501,11929,2018,Sep
2018-09,South Dakota,1054,1975,3564,184,5723,2018,Sep
2018-09,Tennessee,14255,18721,11942,1167,31830,2018,Sep
2018-09,Texas,39254,33746,33087,2907,69740,2018,Sep
2018-09,Utah,10846,2678,3400,274,6352,2018,Sep
2018-09,Vermont,0,1486,1853,114,3453,2018,Sep
2018-09,Virgin Islands,77,21,1,0,22,2018,Sep
2018-09,Virginia,2169,16923,12040,2448,31411,2018,Sep
2018-09,Washington,11446,13517,11021,1953,26491,2018,Sep
2018-09,West Virginia,1973,4914,5918,248,11080,2018,Sep
2018-09,Wisconsin,7944,11254,12707,762,24723,2018,Sep
2018-09,Wyoming,564,1545,2235,121,3901,2018,Sep
2018-08,Alabama,22465,5991,5741,218,11950,2018,Aug
2018-08,Alaska,218,2593,3057,220,5870,2018,Aug
2018-08,Arizona,12014,10833,6987,887,18707,2018,Aug
2018-08,Arkansas,5684,4809,5590,226,10625,2018,Aug
2018-08,California,38687,34617,25666,3117,63400,2018,Aug
2018-08,Colorado,10004,16160,12392,1062,29614,2018,Aug
2018-08,Connecticut,7057,4519,1690,605,6814,2018,Aug
2018-08,Delaware,173,1262,1162,85,2509,2018,Aug
2018-08,District of Columbia,235,91,1,0,92,2018,Aug
2018-08,Florida,17524,44227,15734,3176,63137,2018,Aug
2018-08,Georgia,17288,10894,7419,431,18744,2018,Aug
2018-08,Guam,0,84,37,9,130,2018,Aug
2018-08,Hawaii,1125,0,0,0,0,2018,Aug
2018-08,Idaho,5550,3374,3899,254,7527,2018,Aug
2018-08,Illinois,14583,17992,9858,0,27850,2018,Aug
2018-08,Indiana,31327,15764,10339,1252,27355,2018,Aug
2018-08,Iowa,6819,160,1935,18,2113,2018,Aug
2018-08,Kansas,1902,4500,4505,365,9370,2018,Aug
2018-08,Kentucky,393679,7250,6241,306,13797,2018,Aug
2018-08,Louisiana,2866,9103,8745,693,18541,2018,Aug
2018-08,Maine,466,2835,2946,236,6017,2018,Aug
2018-08,Mariana Islands,0,6,7,0,13,2018,Aug
2018-08,Maryland,2612,4148,4001,103,8252,2018,Aug
2018-08,Massachusetts,10497,4322,2396,428,7146,2018,Aug
2018-08,Michigan,19265,8110,7973,440,16523,2018,Aug
2018-08,Minnesota,28585,3773,8142,312,12227,2018,Aug
2018-08,Mississippi,2496,7489,6695,320,14504,2018,Aug
2018-08,Missouri,1381,16706,13657,1371,31734,2018,Aug
2018-08,Montana,1069,2617,3805,162,6584,2018,Aug
2018-08,Nebraska,2744,95,1493,16,1604,2018,Aug
2018-08,Nevada,2104,4164,2137,271,6572,2018,Aug
2018-08,New Hampshire,1431,4382,2960,139,7481,2018,Aug
2018-08,New Jersey,0,4069,2968,179,7216,2018,Aug
2018-08,New Mexico,796,5303,4077,421,9801,2018,Aug
2018-08,New York,2942,8314,11362,970,20646,2018,Aug
2018-08,North Carolina,22956,1180,10190,738,12108,2018,Aug
2018-08,North Dakota,546,1284,2475,102,3861,2018,Aug
2018-08,Ohio,14802,18482,12449,1181,32112,2018,Aug
2018-08,Oklahoma,8,9823,8558,981,19362,2018,Aug
2018-08,Oregon,4732,11938,8751,0,20689,2018,Aug
2018-08,Pennsylvania,23896,38142,11911,48,50101,2018,Aug
2018-08,Puerto Rico,0,2414,247,90,2751,2018,Aug
2018-08,Rhode Island,0,911,589,66,1566,2018,Aug
2018-08,South Carolina,10452,8135,5763,513,14411,2018,Aug
2018-08,South Dakota,1426,2012,3041,155,5208,2018,Aug
2018-08,Tennessee,17141,20996,13165,1112,35273,2018,Aug
2018-08,Texas,45037,37819,35212,2934,75965,2018,Aug
2018-08,Utah,15480,2650,2996,254,5900,2018,Aug
2018-08,Vermont,0,1336,1251,99,2686,2018,Aug
2018-08,Virgin Islands,27,27,2,1,30,2018,Aug
2018-08,Virginia,1786,18729,11694,2329,32752,2018,Aug
2018-08,Washington,13560,14615,9761,1874,26250,2018,Aug
2018-08,West Virginia,2248,4986,4987,265,10238,2018,Aug
2018-08,Wisconsin,9330,11118,10987,697,22802,2018,Aug
2018-08,Wyoming,279,1570,2059,87,3716,2018,Aug
2018-07,Alabama,20642,5110,4540,222,9872,2018,Jul
2018-07,Alaska,307,2391,2195,180,4766,2018,Jul
2018-07,Arizona,6265,10166,5848,1020,17034,2018,Jul
2018-07,Arkansas,7406,4245,3625,237,8107,2018,Jul
2018-07,California,39153,30486,21136,3054,54676,2018,Jul
2018-07,Colorado,9818,15420,10239,1106,26765,2018,Jul
2018-07,Connecticut,6810,4379,1611,445,6435,2018,Jul
2018-07,Delaware,266,1314,950,103,2367,2018,Jul
2018-07,District of Columbia,156,88,2,0,90,2018,Jul
2018-07,Florida,15888,42524,13468,3215,59207,2018,Jul
2018-07,Georgia,15689,9759,5232,469,15460,2018,Jul
2018-07,Guam,0,93,43,6,142,2018,Jul
2018-07,Hawaii,1050,0,0,0,0,2018,Jul
2018-07,Idaho,6898,3202,3160,247,6609,2018,Jul
2018-07,Illinois,13684,16840,7743,0,24583,2018,Jul
2018-07,Indiana,36004,13914,7825,1101,22840,2018,Jul
2018-07,Iowa,4429,76,1469,31,1576,2018,Jul
2018-07,Kansas,1781,4579,3410,444,8433,2018,Jul
2018-07,Kentucky,379409,6306,4537,295,11138,2018,Jul
2018-07,Louisiana,2657,8596,6115,665,15376,2018,Jul
2018-07,Maine,533,2542,2294,222,5058,2018,Jul
2018-07,Mariana Islands,0,5,7,3,15,2018,Jul
2018-07,Maryland,2424,3730,3398,115,7243,2018,Jul
2018-07,Massachusetts,8310,3380,1997,383,5760,2018,Jul
2018-07,Michigan,17657,7846,6018,457,14321,2018,Jul
2018-07,Minnesota,26954,3275,5135,310,8720,2018,Jul
2018-07,Mississippi,1850,5884,3568,291,9743,2018,Jul
2018-07,Missouri,733,14330,10470,1187,25987,2018,Jul
2018-07,Montana,995,2421,2865,192,5478,2018,Jul
2018-07,Nebraska,2973,91,1090,16,1197,2018,Jul
2018-07,Nevada,2530,3678,1799,279,5756,2018,Jul
2018-07,New Hampshire,1289,4157,2332,147,6636,2018,Jul
2018-07,New Jersey,0,4193,2486,178,6857,2018,Jul
2018-07,New Mexico,767,4795,3252,423,8470,2018,Jul
2018-07,New York,2615,7901,8692,916,17509,2018,Jul
2018-07,North Carolina,22044,1145,7771,716,9632,2018,Jul
2018-07,North Dakota,589,1079,1791,99,2969,2018,Jul
2018-07,Ohio,13859,16942,10255,1102,28299,2018,Jul
2018-07,Oklahoma,2,8920,6314,903,16137,2018,Jul
2018-07,Oregon,4733,10543,7700,0,18243,2018,Jul
2018-07,Pennsylvania,22245,33494,9738,29,43261,2018,Jul
2018-07,Puerto Rico,0,1968,139,110,2217,2018,Jul
2018-07,Rhode Island,0,799,453,67,1319,2018,Jul
2018-07,South Carolina,4018,6972,4037,592,11601,2018,Jul
2018-07,South Dakota,954,1678,2160,165,4003,2018,Jul
2018-07,Tennessee,18098,19188,9840,1071,30099,2018,Jul
2018-07,Texas,49290,35363,23141,2882,61386,2018,Jul
2018-07,Utah,15950,2603,2497,246,5346,2018,Jul
2018-07,Vermont,0,1156,999,97,2252,2018,Jul
2018-07,Virgin Islands,97,37,2,1,40,2018,Jul
2018-07,Virginia,1802,18547,10039,2474,31060,2018,Jul
2018-07,Washington,12969,13547,8385,1695,23627,2018,Jul
2018-07,West Virginia,2354,4473,3951,242,8666,2018,Jul
2018-07,Wisconsin,8542,9351,7471,693,17515,2018,Jul
2018-07,Wyoming,610,1448,1559,90,3097,2018,Jul
2018-06,Alabama,19140,5868,4646,284,10798,2018,Jun
2018-06,Alaska,250,2788,2324,224,5336,2018,Jun
2018-06,Arizona,7179,10785,5965,1096,17846,2018,Jun
2018-06,Arkansas,6651,4478,3528,297,8303,2018,Jun
2018-06,California,38623,32684,23612,3921,60217,2018,Jun
2018-06,Colorado,9778,15796,10351,1215,27362,2018,Jun
2018-06,Connecticut,7210,4725,1673,368,6766,2018,Jun
2018-06,Delaware,395,1412,1019,171,2602,2018,Jun
2018-06,District of Columbia,176,79,3,0,82,2018,Jun
2018-06,Florida,17573,44821,14764,3586,63171,2018,Jun
2018-06,Georgia,14667,11269,5571,475,17315,2018,Jun
2018-06,Guam,0,92,38,12,142,2018,Jun
2018-06,Hawaii,1168,0,0,0,0,2018,Jun
2018-06,Idaho,6581,3609,3734,301,7644,2018,Jun
2018-06,Illinois,12711,17755,7827,0,25582,2018,Jun
2018-06,Indiana,47508,15459,8455,1214,25128,2018,Jun
2018-06,Iowa,4850,92,1415,39,1546,2018,Jun
2018-06,Kansas,2074,4344,3247,438,8029,2018,Jun
2018-06,Kentucky,395679,7130,4686,304,12120,2018,Jun
2018-06,Louisiana,2937,9703,5683,757,16143,2018,Jun
2018-06,Maine,512,2655,2342,223,5220,2018,Jun
2018-06,Mariana Islands,0,9,7,1,17,2018,Jun
2018-06,Maryland,2154,4095,3608,141,7844,2018,Jun
2018-06,Massachusetts,9045,3996,2249,398,6643,2018,Jun
2018-06,Michigan,17691,8369,6096,568,15033,2018,Jun
2018-06,Minnesota,28390,3603,5075,376,9054,2018,Jun
2018-06,Mississippi,2123,6446,3594,285,10325,2018,Jun
2018-06,Missouri,658,15679,10488,1421,27588,2018,Jun
2018-06,Montana,1171,2592,3377,194,6163,2018,Jun
2018-06,Nebraska,3140,103,1089,17,1209,2018,Jun
2018-06,Nevada,2220,4117,2112,317,6546,2018,Jun
2018-06,New Hampshire,1260,4430,2542,147,7119,2018,Jun
2018-06,New Jersey,0,4609,2626,178,7413,2018,Jun
2018-06,New Mexico,979,5109,3363,471,8943,2018,Jun
2018-06,New York,2168,8745,9688,1028,19461,2018,Jun
2018-06,North Carolina,22909,1348,8100,762,10210,2018,Jun
2018-06,North Dakota,724,1248,1778,100,3126,2018,Jun
2018-06,Ohio,15490,17338,10649,1163,29150,2018,Jun
2018-06,Oklahoma,1,10295,6449,971,17715,2018,Jun
2018-06,Oregon,5105,12700,8659,0,21359,2018,Jun
2018-06,Pennsylvania,22056,37280,10817,29,48126,2018,Jun
2018-06,Puerto Rico,0,2174,187,109,2470,2018,Jun
2018-06,Rhode Island,0,834,582,65,1481,2018,Jun
2018-06,South Carolina,3611,7950,3967,612,12529,2018,Jun
2018-06,South Dakota,954,1880,2313,151,4344,2018,Jun
2018-06,Tennessee,14845,20805,10399,1821,33025,2018,Jun
2018-06,Texas,25805,39032,24252,3160,66444,2018,Jun
2018-06,Utah,22412,2941,2704,277,5922,2018,Jun
2018-06,Vermont,0,1347,1181,107,2635,2018,Jun
2018-06,Virgin Islands,65,46,4,1,51,2018,Jun
2018-06,Virginia,2384,17812,9865,2376,30053,2018,Jun
2018-06,Washington,12764,15069,9423,1865,26357,2018,Jun
2018-06,West Virginia,2315,4988,4109,275,9372,2018,Jun
2018-06,Wisconsin,7537,9993,7627,708,18328,2018,Jun
2018-06,Wyoming,467,1633,1660,95,3388,2018,Jun
2018-05,Alabama,19919,5784,5039,253,11076,2018,May
2018-05,Alaska,318,3363,2879,283,6525,2018,May
2018-05,Arizona,6691,11194,6241,1173,18608,2018,May
2018-05,Arkansas,6293,4355,3442,254,8051,2018,May
2018-05,California,40430,34433,24797,3995,63225,2018,May
2018-05,Colorado,11662,16113,11143,1282,28538,2018,May
2018-05,Connecticut,7459,4454,1775,346,6575,2018,May
2018-05,Delaware,722,1422,1107,175,2704,2018,May
2018-05,District of Columbia,199,88,2,0,90,2018,May
2018-05,Florida,21026,47755,15850,3723,67328,2018,May
2018-05,Georgia,18886,11159,5669,496,17324,2018,May
2018-05,Guam,0,90,46,18,154,2018,May
2018-05,Hawaii,1185,0,0,0,0,2018,May
2018-05,Idaho,9651,3387,3812,302,7501,2018,May
2018-05,Illinois,13239,18631,8397,0,27028,2018,May
2018-05,Indiana,51103,15856,8256,1296,25408,2018,May
2018-05,Iowa,6620,95,1507,36,1638,2018,May
2018-05,Kansas,1816,4305,3307,434,8046,2018,May
2018-05,Kentucky,379571,7620,4696,344,12660,2018,May
2018-05,Louisiana,2794,9039,5435,710,15184,2018,May
2018-05,Maine,754,2978,2362,302,5642,2018,May
2018-05,Mariana Islands,0,6,6,0,12,2018,May
2018-05,Maryland,3076,4503,3961,132,8596,2018,May
2018-05,Massachusetts,11331,4167,2351,410,6928,2018,May
2018-05,Michigan,19715,8598,6049,620,15267,2018,May
2018-05,Minnesota,36965,4034,5435,445,9914,2018,May
2018-05,Mississippi,2717,6653,3624,315,10592,2018,May
2018-05,Missouri,710,15576,10536,1334,27446,2018,May
2018-05,Montana,1279,2557,3578,194,6329,2018,May
2018-05,Nebraska,3803,111,1139,20,1270,2018,May
2018-05,Nevada,2952,4185,2209,321,6715,2018,May
2018-05,New Hampshire,2339,4707,2524,165,7396,2018,May
2018-05,New Jersey,0,4983,2810,244,8037,2018,May
2018-05,New Mexico,1130,5296,3355,497,9148,2018,May
2018-05,New York,2877,8916,10491,1109,20516,2018,May
2018-05,North Carolina,28921,1322,8298,903,10523,2018,May
2018-05,North Dakota,1022,1327,1829,97,3253,2018,May
2018-05,Ohio,17766,18830,10891,1395,31116,2018,May
2018-05,Oklahoma,5,9964,6610,1135,17709,2018,May
2018-05,Oregon,5774,13221,9111,0,22332,2018,May
2018-05,Pennsylvania,23778,39765,10670,31,50466,2018,May
2018-05,Puerto Rico,0,2187,230,155,2572,2018,May
2018-05,Rhode Island,0,977,610,90,1677,2018,May
2018-05,South Carolina,2725,7883,3855,657,12395,2018,May
2018-05,South Dakota,846,1874,2351,195,4420,2018,May
2018-05,Tennessee,18763,20549,10028,1205,31782,2018,May
2018-05,Texas,32974,37893,24419,3348,65660,2018,May
2018-05,Utah,24171,3202,3025,317,6544,2018,May
2018-05,Vermont,2,1322,1241,171,2734,2018,May
2018-05,Virgin Islands,93,37,4,1,42,2018,May
2018-05,Virginia,1222,18493,9958,2409,30860,2018,May
2018-05,Washington,14889,15131,9417,1884,26432,2018,May
2018-05,West Virginia,5229,5258,4037,291,9586,2018,May
2018-05,Wisconsin,8419,10738,8239,914,19891,2018,May
2018-05,Wyoming,670,1734,1813,134,3681,2018,May
2018-04,Alabama,20808,6405,5267,335,12007,2018,Apr
2018-04,Alaska,276,3053,3013,318,6384,2018,Apr
2018-04,Arizona,7102,12889,7176,1435,21500,2018,Apr
2018-04,Arkansas,5363,5129,4326,315,9770,2018,Apr
2018-04,California,53448,37814,25571,3736,67121,2018,Apr
2018-04,Colorado,11917,19015,13280,1744,34039,2018,Apr
2018-04,Connecticut,7142,4977,2151,510,7638,2018,Apr
2018-04,Delaware,764,1767,1697,423,3887,2018,Apr
2018-04,District of Columbia,224,92,4,1,97,2018,Apr
2018-04,Florida,22491,50172,18650,4446,73268,2018,Apr
2018-04,Georgia,21145,12238,6549,665,19452,2018,Apr
2018-04,Guam,0,97,44,10,151,2018,Apr
2018-04,Hawaii,1387,0,0,0,0,2018,Apr
2018-04,Idaho,7497,3843,4182,453,8478,2018,Apr
2018-04,Illinois,18258,23977,10883,0,34860,2018,Apr
2018-04,Indiana,43928,19405,11491,1758,32654,2018,Apr
2018-04,Iowa,10536,156,2140,58,2354,2018,Apr
2018-04,Kansas,1382,5457,4530,654,10641,2018,Apr
2018-04,Kentucky,390433,8893,6662,439,15994,2018,Apr
2018-04,Louisiana,3109,9937,6304,869,17110,2018,Apr
2018-04,Maine,787,3572,3580,382,7534,2018,Apr
2018-04,Mariana Islands,0,12,10,0,22,2018,Apr
2018-04,Maryland,3555,4867,5181,167,10215,2018,Apr
2018-04,Massachusetts,9563,4619,2967,525,8111,2018,Apr
2018-04,Michigan,22715,11288,8635,836,20759,2018,Apr
2018-04,Minnesota,46888,6258,9688,744,16690,2018,Apr
2018-04,Mississippi,2814,7561,4186,422,12169,2018,Apr
2018-04,Missouri,944,18537,13868,1791,34196,2018,Apr
2018-04,Montana,1531,2745,4018,225,6988,2018,Apr
2018-04,Nebraska,4926,111,1478,27,1616,2018,Apr
2018-04,Nevada,3313,4424,2689,382,7495,2018,Apr
2018-04,New Hampshire,1916,5647,3465,211,9323,2018,Apr
2018-04,New Jersey,0,5170,3549,239,8958,2018,Apr
2018-04,New Mexico,1073,5857,4163,578,10598,2018,Apr
2018-04,New York,3950,10068,14667,1722,26457,2018,Apr
2018-04,North Carolina,31747,1340,10138,1121,12599,2018,Apr
2018-04,North Dakota,872,1824,2622,164,4610,2018,Apr
2018-04,Ohio,19651,25111,15459,1971,42541,2018,Apr
2018-04,Oklahoma,4,11599,8386,1629,21614,2018,Apr
2018-04,Oregon,5900,15089,11283,0,26372,2018,Apr
2018-04,Pennsylvania,29767,47093,13434,38,60565,2018,Apr
2018-04,Puerto Rico,0,1936,178,71,2185,2018,Apr
2018-04,Rhode Island,0,1131,773,159,2063,2018,Apr
2018-04,South Carolina,2612,8977,4681,789,14447,2018,Apr
2018-04,South Dakota,917,2403,2994,256,5653,2018,Apr
2018-04,Tennessee,16106,23325,12360,1329,37014,2018,Apr
2018-04,Texas,29547,41373,27019,3930,72322,2018,Apr
2018-04,Utah,20770,3667,3460,442,7569,2018,Apr
2018-04,Vermont,0,2261,2290,356,4907,2018,Apr
2018-04,Virgin Islands,70,55,7,0,62,2018,Apr
2018-04,Virginia,1233,20638,12759,3022,36419,2018,Apr
2018-04,Washington,16239,17123,11153,2319,30595,2018,Apr
2018-04,West Virginia,8021,6251,5479,365,12095,2018,Apr
2018-04,Wisconsin,11655,14507,13478,1394,29379,2018,Apr
2018-04,Wyoming,702,1846,1929,154,3929,2018,Apr
2018-03,Alabama,29286,10050,7695,469,18214,2018,Mar
2018-03,Alaska,261,3080,3276,458,6814,2018,Mar
2018-03,Arizona,7782,16991,10611,1984,29586,2018,Mar
2018-03,Arkansas,4007,8523,7017,551,16091,2018,Mar
2018-03,California,50714,47425,32189,4802,84416,2018,Mar
2018-03,Colorado,14922,24811,17741,2381,44933,2018,Mar
2018-03,Connecticut,7081,6906,2977,665,10548,2018,Mar
2018-03,Delaware,669,2385,2282,527,5194,2018,Mar
2018-03,District of Columbia,284,93,3,0,96,2018,Mar
2018-03,Florida,27957,64230,30487,6732,101449,2018,Mar
2018-03,Georgia,31261,19849,10901,959,31709,2018,Mar
2018-03,Guam,0,78,50,12,140,2018,Mar
2018-03,Hawaii,1417,0,0,0,0,2018,Mar
2018-03,Idaho,11108,5386,5788,611,11785,2018,Mar
2018-03,Illinois,24775,32326,17008,0,49334,2018,Mar
2018-03,Indiana,70713,28224,16982,2950,48156,2018,Mar
2018-03,Iowa,14986,177,3585,73,3835,2018,Mar
2018-03,Kansas,817,8400,6921,965,16286,2018,Mar
2018-03,Kentucky,390708,14642,10303,818,25763,2018,Mar
2018-03,Louisiana,4451,13831,8906,1336,24073,2018,Mar
2018-03,Maine,892,4640,3947,655,9242,2018,Mar
2018-03,Mariana Islands,0,14,7,3,24,2018,Mar
2018-03,Maryland,3653,6360,7182,206,13748,2018,Mar
2018-03,Massachusetts,10734,6636,3974,640,11250,2018,Mar
2018-03,Michigan,27407,17166,12721,1305,31192,2018,Mar
2018-03,Minnesota,51098,7583,11538,1040,20161,2018,Mar
2018-03,Mississippi,3776,12054,7132,608,19794,2018,Mar
2018-03,Missouri,1186,27559,21245,3069,51873,2018,Mar
2018-03,Montana,1845,3992,5369,420,9781,2018,Mar
2018-03,Nebraska,6293,162,2411,50,2623,2018,Mar
2018-03,Nevada,2825,6427,3625,531,10583,2018,Mar
2018-03,New Hampshire,2301,7132,4245,370,11747,2018,Mar
2018-03,New Jersey,0,5178,4758,259,10195,2018,Mar
2018-03,New Mexico,1467,8110,6046,837,14993,2018,Mar
2018-03,New York,3089,11578,17006,2533,31117,2018,Mar
2018-03,North Carolina,37263,1808,16114,1705,19627,2018,Mar
2018-03,North Dakota,775,2195,3201,224,5620,2018,Mar
2018-03,Ohio,21984,36314,24477,3483,64274,2018,Mar
2018-03,Oklahoma,8,15682,12018,2117,29817,2018,Mar
2018-03,Oregon,6514,19409,15464,0,34873,2018,Mar
2018-03,Pennsylvania,34317,67756,19867,53,87676,2018,Mar
2018-03,Puerto Rico,0,1718,182,131,2031,2018,Mar
2018-03,Rhode Island,0,1544,1261,327,3132,2018,Mar
2018-03,South Carolina,4113,13772,7673,1113,22558,2018,Mar
2018-03,South Dakota,1264,3523,4408,348,8279,2018,Mar
2018-03,Tennessee,17501,32501,19418,1997,53916,2018,Mar
2018-03,Texas,37551,60134,38853,5634,104621,2018,Mar
2018-03,Utah,21478,5277,5296,601,11174,2018,Mar
2018-03,Vermont,0,2818,2713,440,5971,2018,Mar
2018-03,Virgin Islands,158,36,1,0,37,2018,Mar
2018-03,Virginia,1120,30568,19180,4820,54568,2018,Mar
2018-03,Washington,18818,22041,15774,3491,41306,2018,Mar
2018-03,West Virginia,18251,9955,8325,701,18981,2018,Mar
2018-03,Wisconsin,15625,19901,18290,1936,40127,2018,Mar
2018-03,Wyoming,602,2502,2536,252,5290,2018,Mar
2018-02,Alabama,24547,9220,7172,353,16745,2018,Feb
2018-02,Alaska,214,2279,1948,268,4495,2018,Feb
2018-02,Arizona,6513,14966,9058,1341,25365,2018,Feb
2018-02,Arkansas,4341,7671,6405,338,14414,2018,Feb
2018-02,California,39165,38531,24768,3940,67239,2018,Feb
2018-02,Colorado,9321,20604,13985,1701,36290,2018,Feb
2018-02,Connecticut,6597,5918,2269,462,8649,2018,Feb
2018-02,Delaware,672,1852,1579,187,3618,2018,Feb
2018-02,District of Columbia,151,62,3,0,65,2018,Feb
2018-02,Florida,21971,57435,26441,4590,88466,2018,Feb
2018-02,Georgia,24308,17618,9410,616,27644,2018,Feb
2018-02,Guam,0,94,33,12,139,2018,Feb
2018-02,Hawaii,1069,0,0,0,0,2018,Feb
2018-02,Idaho,9910,4196,4300,396,8892,2018,Feb
2018-02,Illinois,21425,25626,12938,0,38564,2018,Feb
2018-02,Indiana,39795,24019,13516,2056,39591,2018,Feb
2018-02,Iowa,12031,156,2587,46,2789,2018,Feb
2018-02,Kansas,1990,7467,5818,638,13923,2018,Feb
2018-02,Kentucky,387471,13917,9302,532,23751,2018,Feb
2018-02,Louisiana,2148,11907,7865,902,20674,2018,Feb
2018-02,Maine,596,3556,2797,300,6653,2018,Feb
2018-02,Mariana Islands,0,8,9,2,19,2018,Feb
2018-02,Maryland,2691,4424,5496,149,10069,2018,Feb
2018-02,Massachusetts,7360,5271,3035,459,8765,2018,Feb
2018-02,Michigan,20478,12934,9602,768,23304,2018,Feb
2018-02,Minnesota,35973,5034,7148,597,12779,2018,Feb
2018-02,Mississippi,2568,11031,6516,359,17906,2018,Feb
2018-02,Missouri,744,23601,17167,1927,42695,2018,Feb
2018-02,Montana,1474,2834,3401,258,6493,2018,Feb
2018-02,Nebraska,5289,122,1973,32,2127,2018,Feb
2018-02,Nevada,2823,5510,2898,335,8743,2018,Feb
2018-02,New Hampshire,2346,5778,3076,176,9030,2018,Feb
2018-02,New Jersey,0,4613,3646,200,8459,2018,Feb
2018-02,New Mexico,1170,7244,4985,545,12774,2018,Feb
2018-02,New York,2670,10345,13742,1603,25690,2018,Feb
2018-02,North Carolina,30480,1642,13498,1104,16244,2018,Feb
2018-02,North Dakota,710,1713,2220,149,4082,2018,Feb
2018-02,Ohio,15308,30691,19698,2193,52582,2018,Feb
2018-02,Oklahoma,0,13836,10146,1508,25490,2018,Feb
2018-02,Oregon,5200,15672,11370,0,27042,2018,Feb
2018-02,Pennsylvania,30952,51425,14849,34,66308,2018,Feb
2018-02,Puerto Rico,0,1738,152,139,2029,2018,Feb
2018-02,Rhode Island,0,1272,886,220,2378,2018,Feb
2018-02,South Carolina,5080,12843,6512,862,20217,2018,Feb
2018-02,South Dakota,835,2844,3476,232,6552,2018,Feb
2018-02,Tennessee,16709,31159,16929,1818,49906,2018,Feb
2018-02,Texas,36801,55634,35889,4158,95681,2018,Feb
2018-02,Utah,12863,4175,4055,425,8655,2018,Feb
2018-02,Vermont,0,1876,1708,160,3744,2018,Feb
2018-02,Virgin Islands,3,30,8,0,38,2018,Feb
2018-02,Virginia,1474,26596,15770,3483,45849,2018,Feb
2018-02,Washington,15794,17287,11842,2605,31734,2018,Feb
2018-02,West Virginia,3739,8193,6582,424,15199,2018,Feb
2018-02,Wisconsin,14483,15379,11979,1187,28545,2018,Feb
2018-02,Wyoming,504,1851,1916,142,3909,2018,Feb
2018-01,Alabama,23930,5692,6199,276,12167,2018,Jan
2018-01,Alaska,207,1844,1621,249,3714,2018,Jan
2018-01,Arizona,5686,11659,6992,1074,19725,2018,Jan
2018-01,Arkansas,4162,4935,5061,232,10228,2018,Jan
2018-01,California,55292,37335,22919,3495,63749,2018,Jan
2018-01,Colorado,9683,17498,12153,1307,30958,2018,Jan
2018-01,Connecticut,6015,5044,1829,384,7257,2018,Jan
2018-01,Delaware,639,1422,1224,91,2737,2018,Jan
2018-01,District of Columbia,206,72,4,0,76,2018,Jan
2018-01,Florida,19683,48377,20690,3299,72366,2018,Jan
2018-01,Georgia,23676,10836,7309,477,18622,2018,Jan
2018-01,Guam,0,74,43,11,128,2018,Jan
2018-01,Hawaii,1182,0,0,0,0,2018,Jan
2018-01,Idaho,7505,3001,3270,312,6583,2018,Jan
2018-01,Illinois,18881,21821,9850,0,31671,2018,Jan
2018-01,Indiana,52908,17558,10258,1456,29272,2018,Jan
2018-01,Iowa,13276,119,2004,59,2182,2018,Jan
2018-01,Kansas,1930,5249,4814,537,10600,2018,Jan
2018-01,Kentucky,384989,8202,5736,323,14261,2018,Jan
2018-01,Louisiana,1582,8500,7747,747,16994,2018,Jan
2018-01,Maine,704,2585,1926,230,4741,2018,Jan
2018-01,Mariana Islands,0,5,5,0,10,2018,Jan
2018-01,Maryland,3026,4632,4405,155,9192,2018,Jan
2018-01,Massachusetts,8426,4554,2468,421,7443,2018,Jan
2018-01,Michigan,19922,8499,6395,532,15426,2018,Jan
2018-01,Minnesota,40076,4279,4952,484,9715,2018,Jan
2018-01,Mississippi,2146,6247,5310,306,11863,2018,Jan
2018-01,Missouri,742,17240,12403,1364,31007,2018,Jan
2018-01,Montana,1278,1930,2749,180,4859,2018,Jan
2018-01,Nebraska,4602,106,1717,31,1854,2018,Jan
2018-01,Nevada,2461,4280,2217,303,6800,2018,Jan
2018-01,New Hampshire,1914,4277,2352,138,6767,2018,Jan
2018-01,New Jersey,0,4309,3491,210,8010,2018,Jan
2018-01,New Mexico,1209,4995,3801,462,9258,2018,Jan
2018-01,New York,2977,9091,10156,1126,20373,2018,Jan
2018-01,North Carolina,27638,1271,9931,855,12057,2018,Jan
2018-01,North Dakota,789,1331,1914,130,3375,2018,Jan
2018-01,Ohio,13183,21340,12521,1704,35565,2018,Jan
2018-01,Oklahoma,0,9971,8351,1072,19394,2018,Jan
2018-01,Oregon,5158,12689,8976,0,21665,2018,Jan
2018-01,Pennsylvania,29797,37308,10242,27,47577,2018,Jan
2018-01,Puerto Rico,0,1693,168,101,1962,2018,Jan
2018-01,Rhode Island,0,1010,618,64,1692,2018,Jan
2018-01,South Carolina,6304,7896,5151,667,13714,2018,Jan
2018-01,South Dakota,872,2217,2799,191,5207,2018,Jan
2018-01,Tennessee,20657,21023,12372,1125,34520,2018,Jan
2018-01,Texas,36042,40443,29960,3400,73803,2018,Jan
2018-01,Utah,13727,3181,3135,316,6632,2018,Jan
2018-01,Vermont,0,1116,1000,105,2221,2018,Jan
2018-01,Virgin Islands,90,40,7,0,47,2018,Jan
2018-01,Virginia,1109,19443,12248,2374,34065,2018,Jan
2018-01,Washington,18112,16327,9811,2170,28308,2018,Jan
2018-01,West Virginia,2838,5128,4452,316,9896,2018,Jan
2018-01,Wisconsin,16462,10484,8337,945,19766,2018,Jan
2018-01,Wyoming,384,1460,1534,138,3132,2018,Jan
2017-12,Alabama,24496,12895,15765,390,29050,2017,Dec
2017-12,Alaska,249,3675,3524,287,7486,2017,Dec
2017-12,Arizona,6243,17566,12840,1414,31820,2017,Dec
2017-12,Arkansas,3339,9189,13104,347,22640,2017,Dec
2017-12,California,53885,47613,35240,4885,87738,2017,Dec
2017-12,Colorado,8736,26649,21168,1736,49553,2017,Dec
2017-12,Connecticut,5424,6646,2630,430,9706,2017,Dec
2017-12,Delaware,360,2295,2473,126,4894,2017,Dec
2017-12,District of Columbia,139,60,5,0,65,2017,Dec
2017-12,Florida,20978,68075,37127,4067,109269,2017,Dec
2017-12,Georgia,18503,21017,20162,677,41856,2017,Dec
2017-12,Guam,0,90,68,18,176,2017,Dec
2017-12,Hawaii,1118,0,0,0,0,2017,Dec
2017-12,Idaho,4975,5911,7393,360,13664,2017,Dec
2017-12,Illinois,18020,27956,15126,0,43082,2017,Dec
2017-12,Indiana,41805,26719,19906,1839,48464,2017,Dec
2017-12,Iowa,10375,231,4678,48,4957,2017,Dec
2017-12,Kansas,1581,9164,10222,597,19983,2017,Dec
2017-12,Kentucky,380648,16727,16102,502,33331,2017,Dec
2017-12,Louisiana,1608,15819,20448,981,37248,2017,Dec
2017-12,Maine,443,3873,4336,289,8498,2017,Dec
2017-12,Mariana Islands,0,10,8,2,20,2017,Dec
2017-12,Maryland,2761,4611,8110,253,12974,2017,Dec
2017-12,Massachusetts,7619,5954,3448,432,9834,2017,Dec
2017-12,Michigan,17058,13425,13836,641,27902,2017,Dec
2017-12,Minnesota,33548,5940,10334,596,16870,2017,Dec
2017-12,Mississippi,1977,12946,16470,418,29834,2017,Dec
2017-12,Missouri,841,28561,27288,2007,57856,2017,Dec
2017-12,Montana,1127,4154,6060,249,10463,2017,Dec
2017-12,Nebraska,4660,197,3773,32,4002,2017,Dec
2017-12,Nevada,1994,6236,4188,386,10810,2017,Dec
2017-12,New Hampshire,2099,5977,3690,155,9822,2017,Dec
2017-12,New Jersey,0,4039,5089,213,9341,2017,Dec
2017-12,New Mexico,945,8205,7494,556,16255,2017,Dec
2017-12,New York,2757,10187,19662,1329,31178,2017,Dec
2017-12,North Carolina,24036,2452,25060,1062,28574,2017,Dec
2017-12,North Dakota,793,2019,3285,104,5408,2017,Dec
2017-12,Ohio,10932,34374,27651,1773,63798,2017,Dec
2017-12,Oklahoma,0,17164,18071,1365,36600,2017,Dec
2017-12,Oregon,4602,18409,15342,0,33751,2017,Dec
2017-12,Pennsylvania,29194,57826,19809,59,77694,2017,Dec
2017-12,Puerto Rico,0,2291,305,114,2710,2017,Dec
2017-12,Rhode Island,0,1169,790,94,2053,2017,Dec
2017-12,South Carolina,6004,14549,14083,900,29532,2017,Dec
2017-12,South Dakota,818,3537,5348,230,9115,2017,Dec
2017-12,Tennessee,19260,37860,28825,1984,68669,2017,Dec
2017-12,Texas,24815,70767,66779,4312,141858,2017,Dec
2017-12,Utah,10954,6429,8577,398,15404,2017,Dec
2017-12,Vermont,0,1722,1824,115,3661,2017,Dec
2017-12,Virgin Islands,108,22,1,0,23,2017,Dec
2017-12,Virginia,727,31084,25165,3408,59657,2017,Dec
2017-12,Washington,14326,21090,16101,2466,39657,2017,Dec
2017-12,West Virginia,2207,10383,11484,399,22266,2017,Dec
2017-12,Wisconsin,15392,15745,14414,1051,31210,2017,Dec
2017-12,Wyoming,435,2763,3104,165,6032,2017,Dec
2017-11,Alabama,21670,9927,11675,292,21894,2017,Nov
2017-11,Alaska,336,3132,3244,261,6637,2017,Nov
2017-11,Arizona,5857,13763,10322,1092,25177,2017,Nov
2017-11,Arkansas,2622,6981,11574,237,18792,2017,Nov
2017-11,California,54897,44710,35910,4241,84861,2017,Nov
2017-11,Colorado,6887,23682,17832,1483,42997,2017,Nov
2017-11,Connecticut,5096,5757,2708,358,8823,2017,Nov
2017-11,Delaware,200,1802,2244,105,4151,2017,Nov
2017-11,District of Columbia,289,71,3,0,74,2017,Nov
2017-11,Florida,19099,61694,31631,3585,96910,2017,Nov
2017-11,Georgia,18672,16298,15244,495,32037,2017,Nov
2017-11,Guam,0,71,44,10,125,2017,Nov
2017-11,Hawaii,1167,0,0,0,0,2017,Nov
2017-11,Idaho,3426,4603,6292,310,11205,2017,Nov
2017-11,Illinois,19861,26122,16102,0,42224,2017,Nov
2017-11,Indiana,28638,22558,20820,1772,45150,2017,Nov
2017-11,Iowa,9062,280,4847,50,5177,2017,Nov
2017-11,Kansas,1757,7493,9095,474,17062,2017,Nov
2017-11,Kentucky,373308,12568,13718,365,26651,2017,Nov
2017-11,Louisiana,1748,13566,16288,780,30634,2017,Nov
2017-11,Maine,554,3270,4056,220,7546,2017,Nov
2017-11,Mariana Islands,0,16,4,0,20,2017,Nov
2017-11,Maryland,2684,4453,8436,254,13143,2017,Nov
2017-11,Massachusetts,7323,5691,3782,439,9912,2017,Nov
2017-11,Michigan,20375,14115,18434,549,33098,2017,Nov
2017-11,Minnesota,29511,5407,11777,528,17712,2017,Nov
2017-11,Mississippi,1794,9779,12312,322,22413,2017,Nov
2017-11,Missouri,692,23099,26209,1428,50736,2017,Nov
2017-11,Montana,1040,3171,5243,186,8600,2017,Nov
2017-11,Nebraska,4265,216,3612,18,3846,2017,Nov
2017-11,Nevada,2145,5350,3425,318,9093,2017,Nov
2017-11,New Hampshire,2387,5266,3743,132,9141,2017,Nov
2017-11,New Jersey,0,3771,5459,203,9433,2017,Nov
2017-11,New Mexico,1134,7206,5820,437,13463,2017,Nov
2017-11,New York,2351,9160,21742,1308,32210,2017,Nov
2017-11,North Carolina,23962,2123,19943,860,22926,2017,Nov
2017-11,North Dakota,558,1924,3382,136,5442,2017,Nov
2017-11,Ohio,10890,30973,28808,1690,61471,2017,Nov
2017-11,Oklahoma,0,15302,15953,1223,32478,2017,Nov
2017-11,Oregon,4794,15988,13094,0,29082,2017,Nov
2017-11,Pennsylvania,27003,54967,21597,44,76608,2017,Nov
2017-11,Puerto Rico,0,1926,257,79,2262,2017,Nov
2017-11,Rhode Island,0,1082,742,142,1966,2017,Nov
2017-11,South Carolina,8922,11512,10108,563,22183,2017,Nov
2017-11,South Dakota,687,3049,5354,242,8645,2017,Nov
2017-11,Tennessee,17602,31618,23889,1635,57142,2017,Nov
2017-11,Texas,33293,59840,51536,3450,114826,2017,Nov
2017-11,Utah,11644,5158,6418,320,11896,2017,Nov
2017-11,Vermont,0,1231,1839,100,3170,2017,Nov
2017-11,Virgin Islands,55,29,1,0,30,2017,Nov
2017-11,Virginia,995,26229,22897,3007,52133,2017,Nov
2017-11,Washington,12865,18326,14345,2281,34952,2017,Nov
2017-11,West Virginia,1927,7302,10878,302,18482,2017,Nov
2017-11,Wisconsin,14647,14237,18174,823,33234,2017,Nov
2017-11,Wyoming,280,2165,2545,148,4858,2017,Nov
2017-10,Alabama,20017,6144,6999,308,13451,2017,Oct
2017-10,Alaska,198,3153,3469,333,6955,2017,Oct
2017-10,Arizona,6097,10614,8055,1100,19769,2017,Oct
2017-10,Arkansas,3865,4873,7420,249,12542,2017,Oct
2017-10,California,49259,39879,25749,3646,69274,2017,Oct
2017-10,Colorado,4075,17238,15967,1428,34633,2017,Oct
2017-10,Connecticut,5093,5112,2233,310,7655,2017,Oct
2017-10,Delaware,208,1602,1587,86,3275,2017,Oct
2017-10,District of Columbia,145,68,2,0,70,2017,Oct
2017-10,Florida,18090,49568,24580,3958,78106,2017,Oct
2017-10,Georgia,16145,12031,10482,483,22996,2017,Oct
2017-10,Guam,0,84,35,11,130,2017,Oct
2017-10,Hawaii,1231,0,0,0,0,2017,Oct
2017-10,Idaho,4710,3310,5517,269,9096,2017,Oct
2017-10,Illinois,17529,20093,12503,0,32596,2017,Oct
2017-10,Indiana,23109,15966,13202,1450,30618,2017,Oct
2017-10,Iowa,8034,126,3209,29,3364,2017,Oct
2017-10,Kansas,2341,5003,5818,433,11254,2017,Oct
2017-10,Kentucky,379403,8758,8739,371,17868,2017,Oct
2017-10,Louisiana,1817,9552,12222,827,22601,2017,Oct
2017-10,Maine,628,3076,5806,252,9134,2017,Oct
2017-10,Mariana Islands,0,4,4,0,8,2017,Oct
2017-10,Maryland,2779,4332,5991,213,10536,2017,Oct
2017-10,Massachusetts,8116,4950,3030,450,8430,2017,Oct
2017-10,Michigan,20487,9807,12649,522,22978,2017,Oct
2017-10,Minnesota,34015,4834,14555,516,19905,2017,Oct
2017-10,Mississippi,1551,6690,7193,302,14185,2017,Oct
2017-10,Missouri,748,17985,19508,1464,38957,2017,Oct
2017-10,Montana,1119,2578,5884,189,8651,2017,Oct
2017-10,Nebraska,3768,118,2469,11,2598,2017,Oct
2017-10,Nevada,1789,4361,2884,360,7605,2017,Oct
2017-10,New Hampshire,2019,4425,3568,147,8140,2017,Oct
2017-10,New Jersey,0,3798,3869,185,7852,2017,Oct
2017-10,New Mexico,1025,5651,4928,465,11044,2017,Oct
2017-10,New York,2877,8501,17695,1320,27516,2017,Oct
2017-10,North Carolina,22591,1501,13877,757,16135,2017,Oct
2017-10,North Dakota,632,1367,3732,134,5233,2017,Oct
2017-10,Ohio,10458,22833,18172,1593,42598,2017,Oct
2017-10,Oklahoma,0,9485,10552,1066,21103,2017,Oct
2017-10,Oregon,4205,12356,11042,0,23398,2017,Oct
2017-10,Pennsylvania,26555,43923,15604,67,59594,2017,Oct
2017-10,Puerto Rico,0,1116,124,53,1293,2017,Oct
2017-10,Rhode Island,0,937,799,120,1856,2017,Oct
2017-10,South Carolina,9780,8269,7166,444,15879,2017,Oct
2017-10,South Dakota,720,2098,5636,182,7916,2017,Oct
2017-10,Tennessee,16465,21614,16131,1285,39030,2017,Oct
2017-10,Texas,30780,41780,39297,3633,84710,2017,Oct
2017-10,Utah,11002,3075,4257,287,7619,2017,Oct
2017-10,Vermont,0,1324,1935,109,3368,2017,Oct
2017-10,Virgin Islands,49,19,0,0,19,2017,Oct
2017-10,Virginia,1006,20450,16169,2637,39256,2017,Oct
2017-10,Washington,12602,14867,13022,2092,29981,2017,Oct
2017-10,West Virginia,2046,5527,7375,350,13252,2017,Oct
2017-10,Wisconsin,14488,11834,15385,830,28049,2017,Oct
2017-10,Wyoming,288,1321,2107,119,3547,2017,Oct
2017-09,Alabama,16717,5734,6320,221,12275,2017,Sep
2017-09,Alaska,209,2320,2930,219,5469,2017,Sep
2017-09,Arizona,5069,11063,7946,920,19929,2017,Sep
2017-09,Arkansas,2935,4347,6063,165,10575,2017,Sep
2017-09,California,57839,37165,24581,2984,64730,2017,Sep
2017-09,Colorado,4356,15751,13448,1007,30206,2017,Sep
2017-09,Connecticut,4343,4834,1993,274,7101,2017,Sep
2017-09,Delaware,275,1414,1538,66,3018,2017,Sep
2017-09,District of Columbia,1,56,4,0,60,2017,Sep
2017-09,Florida,10784,39199,17949,2319,59467,2017,Sep
2017-09,Georgia,12074,10933,7982,315,19230,2017,Sep
2017-09,Guam,0,74,47,10,131,2017,Sep
2017-09,Hawaii,946,0,0,0,0,2017,Sep
2017-09,Idaho,5162,3058,5241,187,8486,2017,Sep
2017-09,Illinois,15712,18290,10201,0,28491,2017,Sep
2017-09,Indiana,18241,16093,11332,1123,28548,2017,Sep
2017-09,Iowa,5847,151,2640,27,2818,2017,Sep
2017-09,Kansas,1567,4518,5025,306,9849,2017,Sep
2017-09,Kentucky,378384,8112,7543,253,15908,2017,Sep
2017-09,Louisiana,1827,10495,11573,635,22703,2017,Sep
2017-09,Maine,783,3026,4220,179,7425,2017,Sep
2017-09,Mariana Islands,0,12,3,0,15,2017,Sep
2017-09,Maryland,2424,3389,4897,168,8454,2017,Sep
2017-09,Massachusetts,7160,4749,2808,449,8006,2017,Sep
2017-09,Michigan,16571,8654,10676,379,19709,2017,Sep
2017-09,Minnesota,25645,4862,12677,346,17885,2017,Sep
2017-09,Mississippi,1362,6260,6035,206,12501,2017,Sep
2017-09,Missouri,791,16993,14395,1050,32438,2017,Sep
2017-09,Montana,1076,2395,4878,140,7413,2017,Sep
2017-09,Nebraska,3036,110,1989,11,2110,2017,Sep
2017-09,Nevada,1952,3992,2509,251,6752,2017,Sep
2017-09,New Hampshire,2795,4410,3248,132,7790,2017,Sep
2017-09,New Jersey,0,3985,3040,140,7165,2017,Sep
2017-09,New Mexico,847,5309,4508,353,10170,2017,Sep
2017-09,New York,2933,8392,16213,998,25603,2017,Sep
2017-09,North Carolina,19292,1235,11340,657,13232,2017,Sep
2017-09,North Dakota,486,1359,2919,99,4377,2017,Sep
2017-09,Ohio,8741,21085,14998,1202,37285,2017,Sep
2017-09,Oklahoma,0,8869,9020,741,18630,2017,Sep
2017-09,Oregon,3774,11557,11773,0,23330,2017,Sep
2017-09,Pennsylvania,23144,39825,13222,48,53095,2017,Sep
2017-09,Puerto Rico,0,619,123,17,759,2017,Sep
2017-09,Rhode Island,0,907,619,70,1596,2017,Sep
2017-09,South Carolina,9380,7574,6037,379,13990,2017,Sep
2017-09,South Dakota,562,2020,4155,154,6329,2017,Sep
2017-09,Tennessee,16887,19219,13746,1042,34007,2017,Sep
2017-09,Texas,31390,39119,39416,2768,81303,2017,Sep
2017-09,Utah,12094,2840,3960,212,7012,2017,Sep
2017-09,Vermont,0,1276,1591,90,2957,2017,Sep
2017-09,Virgin Islands,1,6,2,0,8,2017,Sep
2017-09,Virginia,585,19676,15075,1100,35851,2017,Sep
2017-09,Washington,11451,13292,11548,1623,26463,2017,Sep
2017-09,West Virginia,1668,5204,6161,216,11581,2017,Sep
2017-09,Wisconsin,12224,10918,13133,612,24663,2017,Sep
2017-09,Wyoming,280,1337,2015,61,3413,2017,Sep
2017-08,Alabama,19733,6289,6045,216,12550,2017,Aug
2017-08,Alaska,247,2656,3097,207,5960,2017,Aug
2017-08,Arizona,6733,10864,7686,908,19458,2017,Aug
2017-08,Arkansas,3313,4827,5297,220,10344,2017,Aug
2017-08,California,59528,41110,26220,3058,70388,2017,Aug
2017-08,Colorado,5219,16610,12925,1013,30548,2017,Aug
2017-08,Connecticut,5896,5289,1988,290,7567,2017,Aug
2017-08,Delaware,288,1571,1349,94,3014,2017,Aug
2017-08,District of Columbia,19,54,6,0,60,2017,Aug
2017-08,Florida,18362,46682,21717,2847,71246,2017,Aug
2017-08,Georgia,15046,11719,7797,377,19893,2017,Aug
2017-08,Guam,0,105,47,5,157,2017,Aug
2017-08,Hawaii,1077,0,0,0,0,2017,Aug
2017-08,Idaho,4736,3216,3966,186,7368,2017,Aug
2017-08,Illinois,17053,19807,11333,0,31140,2017,Aug
2017-08,Indiana,15664,17271,11844,1132,30247,2017,Aug
2017-08,Iowa,6094,134,2002,21,2157,2017,Aug
2017-08,Kansas,1642,5005,4743,330,10078,2017,Aug
2017-08,Kentucky,376016,8039,6555,244,14838,2017,Aug
2017-08,Louisiana,2450,10124,8788,632,19544,2017,Aug
2017-08,Maine,1109,3019,2965,196,6180,2017,Aug
2017-08,Mariana Islands,0,16,7,1,24,2017,Aug
2017-08,Maryland,2629,3657,4807,153,8617,2017,Aug
2017-08,Massachusetts,8288,4713,2507,457,7677,2017,Aug
2017-08,Michigan,18347,9849,9962,415,20226,2017,Aug
2017-08,Minnesota,28449,5446,11294,418,17158,2017,Aug
2017-08,Mississippi,1703,9059,7738,251,17048,2017,Aug
2017-08,Missouri,897,17369,13918,1227,32514,2017,Aug
2017-08,Montana,1230,2597,4034,128,6759,2017,Aug
2017-08,Nebraska,3180,109,1667,16,1792,2017,Aug
2017-08,Nevada,1788,4052,2251,229,6532,2017,Aug
2017-08,New Hampshire,2065,4164,2885,121,7170,2017,Aug
2017-08,New Jersey,0,4238,3038,167,7443,2017,Aug
2017-08,New Mexico,1183,5000,3734,396,9130,2017,Aug
2017-08,New York,2952,9159,13239,891,23289,2017,Aug
2017-08,North Carolina,23051,1194,11949,649,13792,2017,Aug
2017-08,North Dakota,444,1500,2567,92,4159,2017,Aug
2017-08,Ohio,10264,21432,14447,1242,37121,2017,Aug
2017-08,Oklahoma,0,9732,8978,819,19529,2017,Aug
2017-08,Oregon,3993,11780,8979,0,20759,2017,Aug
2017-08,Pennsylvania,24329,40628,13170,78,53876,2017,Aug
2017-08,Puerto Rico,0,1169,227,42,1438,2017,Aug
2017-08,Rhode Island,0,883,596,68,1547,2017,Aug
2017-08,South Carolina,12255,8268,6421,412,15101,2017,Aug
2017-08,South Dakota,737,2082,3233,180,5495,2017,Aug
2017-08,Tennessee,14548,19965,14204,1191,35360,2017,Aug
2017-08,Texas,22971,37277,34884,2093,74254,2017,Aug
2017-08,Utah,15013,2790,3154,190,6134,2017,Aug
2017-08,Vermont,0,1232,1254,94,2580,2017,Aug
2017-08,Virgin Islands,81,47,4,0,51,2017,Aug
2017-08,Virginia,2220,20797,14926,1161,36884,2017,Aug
2017-08,Washington,12068,13788,9776,1529,25093,2017,Aug
2017-08,West Virginia,2028,4946,4651,241,9838,2017,Aug
2017-08,Wisconsin,12647,12749,14317,642,27708,2017,Aug
2017-08,Wyoming,408,1411,1762,62,3235,2017,Aug
2017-07,Alabama,18042,6046,4790,224,11060,2017,Jul
2017-07,Alaska,222,2911,2458,238,5607,2017,Jul
2017-07,Arizona,5606,10194,6363,999,17556,2017,Jul
2017-07,Arkansas,2564,4343,3804,189,8336,2017,Jul
2017-07,California,52610,37027,21721,2514,61262,2017,Jul
2017-07,Colorado,4392,16063,11065,1004,28132,2017,Jul
2017-07,Connecticut,6387,5450,1771,280,7501,2017,Jul
2017-07,Delaware,305,1417,1000,71,2488,2017,Jul
2017-07,District of Columbia,19,44,5,0,49,2017,Jul
2017-07,Florida,16978,47430,18941,2975,69346,2017,Jul
2017-07,Georgia,14623,10685,6166,365,17216,2017,Jul
2017-07,Guam,0,71,45,15,131,2017,Jul
2017-07,Hawaii,1107,0,0,0,0,2017,Jul
2017-07,Idaho,4539,2887,3276,191,6354,2017,Jul
2017-07,Illinois,13652,18417,9895,0,28312,2017,Jul
2017-07,Indiana,19386,15385,9995,950,26330,2017,Jul
2017-07,Iowa,5099,94,1649,22,1765,2017,Jul
2017-07,Kansas,3667,4636,3914,325,8875,2017,Jul
2017-07,Kentucky,374603,7236,5118,241,12595,2017,Jul
2017-07,Louisiana,1930,9420,5992,663,16075,2017,Jul
2017-07,Maine,390,2695,2259,144,5098,2017,Jul
2017-07,Mariana Islands,0,11,1,0,12,2017,Jul
2017-07,Maryland,2025,3710,3922,172,7804,2017,Jul
2017-07,Massachusetts,6185,4034,2150,332,6516,2017,Jul
2017-07,Michigan,15464,9305,7687,339,17331,2017,Jul
2017-07,Minnesota,27018,5181,7734,430,13345,2017,Jul
2017-07,Mississippi,1506,5961,3980,247,10188,2017,Jul
2017-07,Missouri,716,16151,11098,1013,28262,2017,Jul
2017-07,Montana,1043,2307,3168,137,5612,2017,Jul
2017-07,Nebraska,2656,97,1204,10,1311,2017,Jul
2017-07,Nevada,1805,3647,1962,219,5828,2017,Jul
2017-07,New Hampshire,1451,4228,2427,128,6783,2017,Jul
2017-07,New Jersey,0,4351,2519,164,7034,2017,Jul
2017-07,New Mexico,1009,4834,3254,361,8449,2017,Jul
2017-07,New York,2315,9212,11301,879,21392,2017,Jul
2017-07,North Carolina,20102,1059,9316,551,10926,2017,Jul
2017-07,North Dakota,496,1286,2030,85,3401,2017,Jul
2017-07,Ohio,9440,20990,14131,1227,36348,2017,Jul
2017-07,Oklahoma,0,9377,6698,882,16957,2017,Jul
2017-07,Oregon,3998,11160,7877,0,19037,2017,Jul
2017-07,Pennsylvania,23669,37329,11694,159,49182,2017,Jul
2017-07,Puerto Rico,0,1115,187,44,1346,2017,Jul
2017-07,Rhode Island,0,836,593,64,1493,2017,Jul
2017-07,South Carolina,11585,7458,4622,405,12485,2017,Jul
2017-07,South Dakota,1138,1926,2355,200,4481,2017,Jul
2017-07,Tennessee,19766,20279,11425,1125,32829,2017,Jul
2017-07,Texas,19006,36913,27245,2653,66811,2017,Jul
2017-07,Utah,11902,2562,2546,202,5310,2017,Jul
2017-07,Vermont,0,1127,1012,87,2226,2017,Jul
2017-07,Virgin Islands,103,39,6,1,46,2017,Jul
2017-07,Virginia,1139,20688,13381,971,35040,2017,Jul
2017-07,Washington,10910,12872,8636,1503,23011,2017,Jul
2017-07,West Virginia,1798,4860,4535,231,9626,2017,Jul
2017-07,Wisconsin,10275,11537,9946,585,22068,2017,Jul
2017-07,Wyoming,279,1231,1395,82,2708,2017,Jul
2017-06,Alabama,19508,8275,4782,254,13311,2017,Jun
2017-06,Alaska,242,2909,2254,225,5388,2017,Jun
2017-06,Arizona,6505,11507,6726,947,19180,2017,Jun
2017-06,Arkansas,3033,5634,4070,190,9894,2017,Jun
2017-06,California,60142,42726,23807,2763,69296,2017,Jun
2017-06,Colorado,4920,17781,11298,1151,30230,2017,Jun
2017-06,Connecticut,8290,6203,1765,243,8211,2017,Jun
2017-06,Delaware,533,1724,1082,74,2880,2017,Jun
2017-06,District of Columbia,17,52,5,0,57,2017,Jun
2017-06,Florida,18831,52114,19380,3260,74754,2017,Jun
2017-06,Georgia,15591,13617,6474,394,20485,2017,Jun
2017-06,Guam,0,94,42,8,144,2017,Jun
2017-06,Hawaii,1082,0,0,0,0,2017,Jun
2017-06,Idaho,11559,3645,3698,184,7527,2017,Jun
2017-06,Illinois,14883,21394,9491,0,30885,2017,Jun
2017-06,Indiana,19163,18351,9706,1093,29150,2017,Jun
2017-06,Iowa,5638,98,1641,36,1775,2017,Jun
2017-06,Kansas,2400,5625,3788,355,9768,2017,Jun
2017-06,Kentucky,373842,8765,5223,265,14253,2017,Jun
2017-06,Louisiana,2011,11706,6324,859,18889,2017,Jun
2017-06,Maine,567,3064,2188,210,5462,2017,Jun
2017-06,Mariana Islands,0,9,2,0,11,2017,Jun
2017-06,Maryland,2477,3968,3963,250,8181,2017,Jun
2017-06,Massachusetts,7347,5612,2287,329,8228,2017,Jun
2017-06,Michigan,17225,11170,7578,463,19211,2017,Jun
2017-06,Minnesota,29559,6258,7505,515,14278,2017,Jun
2017-06,Mississippi,1783,7987,4029,268,12284,2017,Jun
2017-06,Missouri,730,19459,11470,1200,32129,2017,Jun
2017-06,Montana,1518,3026,3727,162,6915,2017,Jun
2017-06,Nebraska,2799,99,1261,22,1382,2017,Jun
2017-06,Nevada,2895,4449,2337,242,7028,2017,Jun
2017-06,New Hampshire,1659,4836,2412,164,7412,2017,Jun
2017-06,New Jersey,0,5022,2586,182,7790,2017,Jun
2017-06,New Mexico,1140,5152,3486,421,9059,2017,Jun
2017-06,New York,2602,10784,11309,921,23014,2017,Jun
2017-06,North Carolina,23048,1581,9570,558,11709,2017,Jun
2017-06,North Dakota,1159,1426,1942,97,3465,2017,Jun
2017-06,Ohio,11147,23703,13536,1324,38563,2017,Jun
2017-06,Oklahoma,0,11872,7459,942,20273,2017,Jun
2017-06,Oregon,4087,13632,9218,0,22850,2017,Jun
2017-06,Pennsylvania,22674,41408,11117,200,52725,2017,Jun
2017-06,Puerto Rico,0,1339,211,32,1582,2017,Jun
2017-06,Rhode Island,0,1053,592,65,1710,2017,Jun
2017-06,South Carolina,13761,11431,4533,473,16437,2017,Jun
2017-06,South Dakota,1266,2215,2458,244,4917,2017,Jun
2017-06,Tennessee,16722,23369,11558,1237,36164,2017,Jun
2017-06,Texas,23877,48895,29119,3000,81014,2017,Jun
2017-06,Utah,14721,3307,2989,208,6504,2017,Jun
2017-06,Vermont,0,1296,973,71,2340,2017,Jun
2017-06,Virgin Islands,126,25,2,0,27,2017,Jun
2017-06,Virginia,728,22416,12706,959,36081,2017,Jun
2017-06,Washington,12964,16674,9805,1694,28173,2017,Jun
2017-06,West Virginia,1889,5409,4165,229,9803,2017,Jun
2017-06,Wisconsin,11645,13463,9959,640,24062,2017,Jun
2017-06,Wyoming,350,1520,1544,107,3171,2017,Jun
2017-05,Alabama,18538,7198,4559,254,12011,2017,May
2017-05,Alaska,247,2851,2459,216,5526,2017,May
2017-05,Arizona,6628,12002,6555,951,19508,2017,May
2017-05,Arkansas,4137,5181,3981,217,9379,2017,May
2017-05,California,58722,42442,24495,2760,69697,2017,May
2017-05,Colorado,5408,17085,11165,1102,29352,2017,May
2017-05,Connecticut,8101,5951,1862,222,8035,2017,May
2017-05,Delaware,863,1752,1087,69,2908,2017,May
2017-05,District of Columbia,10,66,4,0,70,2017,May
2017-05,Florida,19014,49700,18476,3001,71177,2017,May
2017-05,Georgia,14860,12163,6211,406,18780,2017,May
2017-05,Guam,0,93,49,7,149,2017,May
2017-05,Hawaii,1114,0,0,0,0,2017,May
2017-05,Idaho,4933,3267,3699,194,7160,2017,May
2017-05,Illinois,14857,22244,9252,0,31496,2017,May
2017-05,Indiana,24235,18110,9483,1060,28653,2017,May
2017-05,Iowa,6872,196,1759,53,2008,2017,May
2017-05,Kansas,1933,5022,3818,369,9209,2017,May
2017-05,Kentucky,374078,8690,5378,223,14291,2017,May
2017-05,Louisiana,1574,10362,6302,731,17395,2017,May
2017-05,Maine,751,3236,2540,224,6000,2017,May
2017-05,Mariana Islands,0,10,1,1,12,2017,May
2017-05,Maryland,2378,4539,4244,212,8995,2017,May
2017-05,Massachusetts,8372,5100,2526,359,7985,2017,May
2017-05,Michigan,20040,10483,7055,402,17940,2017,May
2017-05,Minnesota,38515,7916,7597,631,16144,2017,May
2017-05,Mississippi,1743,7002,3938,277,11217,2017,May
2017-05,Missouri,685,18290,11468,1067,30825,2017,May
2017-05,Montana,1460,2660,3762,170,6592,2017,May
2017-05,Nebraska,3517,109,1256,23,1388,2017,May
2017-05,Nevada,2017,4630,2288,242,7160,2017,May
2017-05,New Hampshire,1503,4614,2472,158,7244,2017,May
2017-05,New Jersey,0,5569,2931,194,8694,2017,May
2017-05,New Mexico,1183,5204,3381,394,8979,2017,May
2017-05,New York,3224,11633,12857,957,25447,2017,May
2017-05,North Carolina,24726,1363,9129,673,11165,2017,May
2017-05,North Dakota,1017,1413,1866,95,3374,2017,May
2017-05,Ohio,13712,25230,12924,1375,39529,2017,May
2017-05,Oklahoma,0,10599,7270,897,18766,2017,May
2017-05,Oregon,3978,13261,9115,0,22376,2017,May
2017-05,Pennsylvania,24962,42646,11123,157,53926,2017,May
2017-05,Puerto Rico,0,1279,217,67,1563,2017,May
2017-05,Rhode Island,0,1048,541,82,1671,2017,May
2017-05,South Carolina,14550,9258,4234,494,13986,2017,May
2017-05,South Dakota,1331,2369,2578,253,5200,2017,May
2017-05,Tennessee,23584,22198,10745,1187,34130,2017,May
2017-05,Texas,24168,42366,27991,2991,73348,2017,May
2017-05,Utah,16351,3204,3144,214,6562,2017,May
2017-05,Vermont,0,1306,1132,83,2521,2017,May
2017-05,Virgin Islands,55,19,1,0,20,2017,May
2017-05,Virginia,1148,21697,12181,969,34847,2017,May
2017-05,Washington,14176,15915,9682,1617,27214,2017,May
2017-05,West Virginia,2141,5818,4329,262,10409,2017,May
2017-05,Wisconsin,13117,14070,9467,709,24246,2017,May
2017-05,Wyoming,435,1589,1578,101,3268,2017,May
2017-04,Alabama,17958,7131,4724,229,12084,2017,Apr
2017-04,Alaska,289,2997,2840,221,6058,2017,Apr
2017-04,Arizona,7385,13302,7485,1109,21896,2017,Apr
2017-04,Arkansas,3158,5670,4226,191,10087,2017,Apr
2017-04,California,58147,45182,24898,3104,73184,2017,Apr
2017-04,Colorado,5576,19453,12407,1268,33128,2017,Apr
2017-04,Connecticut,7557,6557,2063,178,8798,2017,Apr
2017-04,Delaware,689,2017,1249,90,3356,2017,Apr
2017-04,District of Columbia,35,68,1,0,69,2017,Apr
2017-04,Florida,22072,52889,19489,3290,75668,2017,Apr
2017-04,Georgia,14464,13202,6567,463,20232,2017,Apr
2017-04,Guam,0,93,39,9,141,2017,Apr
2017-04,Hawaii,885,0,0,0,0,2017,Apr
2017-04,Idaho,6062,3874,4039,196,8109,2017,Apr
2017-04,Illinois,15405,25414,10416,0,35830,2017,Apr
2017-04,Indiana,27978,21454,11390,1158,34002,2017,Apr
2017-04,Iowa,9542,252,2348,56,2656,2017,Apr
2017-04,Kansas,3189,5901,4435,402,10738,2017,Apr
2017-04,Kentucky,372852,9858,6519,257,16634,2017,Apr
2017-04,Louisiana,2387,10551,6161,797,17509,2017,Apr
2017-04,Maine,557,3816,3073,242,7131,2017,Apr
2017-04,Mariana Islands,0,11,2,0,13,2017,Apr
2017-04,Maryland,3126,4435,5128,227,9790,2017,Apr
2017-04,Massachusetts,7867,6540,2717,411,9668,2017,Apr
2017-04,Michigan,19168,12478,9139,524,22141,2017,Apr
2017-04,Minnesota,44204,13074,12144,885,26103,2017,Apr
2017-04,Mississippi,1758,7952,4359,245,12556,2017,Apr
2017-04,Missouri,815,20328,14124,1233,35685,2017,Apr
2017-04,Montana,1494,3014,4246,162,7422,2017,Apr
2017-04,Nebraska,3869,126,1648,15,1789,2017,Apr
2017-04,Nevada,2016,4890,2747,243,7880,2017,Apr
2017-04,New Hampshire,1706,5658,3121,165,8944,2017,Apr
2017-04,New Jersey,0,5722,3201,196,9119,2017,Apr
2017-04,New Mexico,1350,5665,4023,502,10190,2017,Apr
2017-04,New York,2879,11913,14591,1111,27615,2017,Apr
2017-04,North Carolina,24568,1471,9870,678,12019,2017,Apr
2017-04,North Dakota,1434,2209,2492,107,4808,2017,Apr
2017-04,Ohio,14485,31417,16030,1580,49027,2017,Apr
2017-04,Oklahoma,0,13317,9111,1159,23587,2017,Apr
2017-04,Oregon,1830,15122,10896,0,26018,2017,Apr
2017-04,Pennsylvania,24949,48255,11877,97,60229,2017,Apr
2017-04,Puerto Rico,0,1105,204,45,1354,2017,Apr
2017-04,Rhode Island,0,1146,673,82,1901,2017,Apr
2017-04,South Carolina,12113,9548,4420,515,14483,2017,Apr
2017-04,South Dakota,1191,2896,3008,308,6212,2017,Apr
2017-04,Tennessee,22073,23031,11521,1164,35716,2017,Apr
2017-04,Texas,21593,44994,28015,3098,76107,2017,Apr
2017-04,Utah,14872,3917,3302,226,7445,2017,Apr
2017-04,Vermont,0,1855,1720,124,3699,2017,Apr
2017-04,Virgin Islands,81,22,7,0,29,2017,Apr
2017-04,Virginia,1074,29480,16844,1227,47551,2017,Apr
2017-04,Washington,13564,17120,10659,1750,29529,2017,Apr
2017-04,West Virginia,2267,6723,5263,257,12243,2017,Apr
2017-04,Wisconsin,14511,16700,13302,873,30875,2017,Apr
2017-04,Wyoming,382,1633,1711,108,3452,2017,Apr
2017-03,Alabama,27666,10603,6951,313,17867,2017,Mar
2017-03,Alaska,362,3067,2640,242,5949,2017,Mar
2017-03,Arizona,9556,14897,9036,1120,25053,2017,Mar
2017-03,Arkansas,4775,7907,6010,281,14198,2017,Mar
2017-03,California,65892,48732,27839,3032,79603,2017,Mar
2017-03,Colorado,7030,21249,14378,1528,37155,2017,Mar
2017-03,Connecticut,8575,7476,2551,182,10209,2017,Mar
2017-03,Delaware,835,2557,1677,95,4329,2017,Mar
2017-03,District of Columbia,24,83,3,0,86,2017,Mar
2017-03,Florida,26986,60787,23982,3609,88378,2017,Mar
2017-03,Georgia,23394,19256,9518,533,29307,2017,Mar
2017-03,Guam,0,74,41,7,122,2017,Mar
2017-03,Hawaii,1086,0,0,0,0,2017,Mar
2017-03,Idaho,5620,4500,4944,289,9733,2017,Mar
2017-03,Illinois,911,30518,14411,0,44929,2017,Mar
2017-03,Indiana,33324,28593,14363,1575,44531,2017,Mar
2017-03,Iowa,16295,316,3137,62,3515,2017,Mar
2017-03,Kansas,2492,7712,5522,558,13792,2017,Mar
2017-03,Kentucky,370113,13769,8992,347,23108,2017,Mar
2017-03,Louisiana,2963,13973,8092,988,23053,2017,Mar
2017-03,Maine,949,4558,3286,305,8149,2017,Mar
2017-03,Mariana Islands,0,9,1,1,11,2017,Mar
2017-03,Maryland,4056,5398,5737,292,11427,2017,Mar
2017-03,Massachusetts,9541,7274,3421,464,11159,2017,Mar
2017-03,Michigan,25819,16031,11103,617,27751,2017,Mar
2017-03,Minnesota,48301,14029,12988,1131,28148,2017,Mar
2017-03,Mississippi,2558,11586,6508,344,18438,2017,Mar
2017-03,Missouri,1253,27625,17931,1537,47093,2017,Mar
2017-03,Montana,2182,3615,4584,299,8498,2017,Mar
2017-03,Nebraska,5011,176,1984,24,2184,2017,Mar
2017-03,Nevada,3754,6038,3219,298,9555,2017,Mar
2017-03,New Hampshire,2480,7278,3462,227,10967,2017,Mar
2017-03,New Jersey,0,6871,3864,258,10993,2017,Mar
2017-03,New Mexico,1467,6752,4571,524,11847,2017,Mar
2017-03,New York,3138,12788,15591,1245,29624,2017,Mar
2017-03,North Carolina,34178,1669,13837,875,16381,2017,Mar
2017-03,North Dakota,1614,2013,2371,124,4508,2017,Mar
2017-03,Ohio,17130,37474,19925,2384,59783,2017,Mar
2017-03,Oklahoma,0,14157,10065,1118,25340,2017,Mar
2017-03,Oregon,1638,17177,13521,0,30698,2017,Mar
2017-03,Pennsylvania,32238,61207,15836,86,77129,2017,Mar
2017-03,Puerto Rico,0,1267,206,48,1521,2017,Mar
2017-03,Rhode Island,0,1424,791,83,2298,2017,Mar
2017-03,South Carolina,19015,13284,6749,680,20713,2017,Mar
2017-03,South Dakota,1773,3361,3686,342,7389,2017,Mar
2017-03,Tennessee,27766,29369,15922,1526,46817,2017,Mar
2017-03,Texas,33412,55983,34308,3702,93993,2017,Mar
2017-03,Utah,17259,4401,4010,284,8695,2017,Mar
2017-03,Vermont,0,2007,1793,125,3925,2017,Mar
2017-03,Virgin Islands,64,27,5,0,32,2017,Mar
2017-03,Virginia,529,29873,17754,1193,48820,2017,Mar
2017-03,Washington,16813,20308,12740,2224,35272,2017,Mar
2017-03,West Virginia,2951,8887,6616,324,15827,2017,Mar
2017-03,Wisconsin,20393,19864,16763,1105,37732,2017,Mar
2017-03,Wyoming,534,2017,2038,134,4189,2017,Mar
2017-02,Alabama,23900,10739,7028,291,18058,2017,Feb
2017-02,Alaska,137,2857,2102,191,5150,2017,Feb
2017-02,Arizona,7938,15642,8881,984,25507,2017,Feb
2017-02,Arkansas,3220,7974,5938,237,14149,2017,Feb
2017-02,California,56533,44363,24987,2898,72248,2017,Feb
2017-02,Colorado,6447,20958,13477,1235,35670,2017,Feb
2017-02,Connecticut,6436,6445,2187,138,8770,2017,Feb
2017-02,Delaware,692,2342,1663,64,4069,2017,Feb
2017-02,District of Columbia,25,65,1,0,66,2017,Feb
2017-02,Florida,23617,59201,23479,2928,85608,2017,Feb
2017-02,Georgia,18666,19007,9334,454,28795,2017,Feb
2017-02,Guam,0,74,43,11,128,2017,Feb
2017-02,Hawaii,1035,0,0,0,0,2017,Feb
2017-02,Idaho,5342,4051,3904,230,8185,2017,Feb
2017-02,Illinois,11166,27418,12635,0,40053,2017,Feb
2017-02,Indiana,92422,27343,13221,1288,41852,2017,Feb
2017-02,Iowa,12039,318,2403,34,2755,2017,Feb
2017-02,Kansas,3179,8082,5501,511,14094,2017,Feb
2017-02,Kentucky,283492,14975,8636,253,23864,2017,Feb
2017-02,Louisiana,3184,12698,7601,846,21145,2017,Feb
2017-02,Maine,696,3758,2544,227,6529,2017,Feb
2017-02,Mariana Islands,0,0,0,0,0,2017,Feb
2017-02,Maryland,3812,4925,5534,213,10672,2017,Feb
2017-02,Massachusetts,8255,6280,2901,404,9585,2017,Feb
2017-02,Michigan,21600,15564,9804,553,25921,2017,Feb
2017-02,Minnesota,38315,12047,9641,791,22479,2017,Feb
2017-02,Mississippi,1966,11285,6045,279,17609,2017,Feb
2017-02,Missouri,1001,26726,16012,1393,44131,2017,Feb
2017-02,Montana,1911,2912,3429,177,6518,2017,Feb
2017-02,Nebraska,4867,171,1937,19,2127,2017,Feb
2017-02,Nevada,2158,5644,2732,301,8677,2017,Feb
2017-02,New Hampshire,2855,6092,3098,156,9346,2017,Feb
2017-02,New Jersey,0,5904,3481,216,9601,2017,Feb
2017-02,New Mexico,1230,7032,4632,400,12064,2017,Feb
2017-02,New York,2794,11465,14080,1128,26673,2017,Feb
2017-02,North Carolina,29573,1410,13488,780,15678,2017,Feb
2017-02,North Dakota,1764,1807,2213,83,4103,2017,Feb
2017-02,Ohio,12784,36244,18068,2030,56342,2017,Feb
2017-02,Oklahoma,0,14051,9769,933,24753,2017,Feb
2017-02,Oregon,972,16425,11726,0,28151,2017,Feb
2017-02,Pennsylvania,27792,54107,12734,37,66878,2017,Feb
2017-02,Puerto Rico,0,1000,197,30,1227,2017,Feb
2017-02,Rhode Island,0,1278,731,94,2103,2017,Feb
2017-02,South Carolina,17148,12510,6324,637,19471,2017,Feb
2017-02,South Dakota,1662,3569,3533,287,7389,2017,Feb
2017-02,Tennessee,19252,31982,16425,1559,49966,2017,Feb
2017-02,Texas,23960,56786,33238,3083,93107,2017,Feb
2017-02,Utah,14815,4371,4252,262,8885,2017,Feb
2017-02,Vermont,0,1885,1538,104,3527,2017,Feb
2017-02,Virgin Islands,72,26,8,0,34,2017,Feb
2017-02,Virginia,838,28434,16587,1170,46191,2017,Feb
2017-02,Washington,13432,18785,11860,2185,32830,2017,Feb
2017-02,West Virginia,2274,8917,6203,281,15401,2017,Feb
2017-02,Wisconsin,18733,18147,12247,858,31252,2017,Feb
2017-02,Wyoming,330,1839,1646,123,3608,2017,Feb
2017-01,Alabama,25093,6770,6572,301,13643,2017,Jan
2017-01,Alaska,185,2028,1631,187,3846,2017,Jan
2017-01,Arizona,8117,12108,7353,951,20412,2017,Jan
2017-01,Arkansas,2512,5174,5278,242,10694,2017,Jan
2017-01,California,62397,41516,22686,2898,67100,2017,Jan
2017-01,Colorado,5619,17189,11864,1128,30181,2017,Jan
2017-01,Connecticut,6706,6133,2115,118,8366,2017,Jan
2017-01,Delaware,736,1815,1466,81,3362,2017,Jan
2017-01,District of Columbia,6,69,6,0,75,2017,Jan
2017-01,Florida,21675,51599,21867,3129,76595,2017,Jan
2017-01,Georgia,20369,12519,7945,460,20924,2017,Jan
2017-01,Guam,0,118,66,12,196,2017,Jan
2017-01,Hawaii,864,0,0,0,0,2017,Jan
2017-01,Idaho,4469,2617,3049,207,5873,2017,Jan
2017-01,Illinois,23670,24594,11185,0,35779,2017,Jan
2017-01,Indiana,45206,21284,11456,1261,34001,2017,Jan
2017-01,Iowa,12527,180,2015,40,2235,2017,Jan
2017-01,Kansas,2643,5798,4969,434,11201,2017,Jan
2017-01,Kentucky,325954,9743,6700,292,16735,2017,Jan
2017-01,Louisiana,5210,10709,8701,819,20229,2017,Jan
2017-01,Maine,692,3094,2447,260,5801,2017,Jan
2017-01,Mariana Islands,0,0,2,0,2,2017,Jan
2017-01,Maryland,3214,4456,5254,185,9895,2017,Jan
2017-01,Massachusetts,10394,6069,2871,379,9319,2017,Jan
2017-01,Michigan,20253,10181,7490,527,18198,2017,Jan
2017-01,Minnesota,66895,9389,7266,851,17506,2017,Jan
2017-01,Mississippi,1914,6805,5592,298,12695,2017,Jan
2017-01,Missouri,975,20123,13512,1257,34892,2017,Jan
2017-01,Montana,1859,2015,2748,172,4935,2017,Jan
2017-01,Nebraska,4237,141,1673,26,1840,2017,Jan
2017-01,Nevada,2518,4235,2361,279,6875,2017,Jan
2017-01,New Hampshire,3583,5332,2836,142,8310,2017,Jan
2017-01,New Jersey,0,5719,3355,200,9274,2017,Jan
2017-01,New Mexico,980,4781,3641,394,8816,2017,Jan
2017-01,New York,3479,11059,13412,1062,25533,2017,Jan
2017-01,North Carolina,29898,1073,11218,802,13093,2017,Jan
2017-01,North Dakota,1315,1370,1892,113,3375,2017,Jan
2017-01,Ohio,11790,27124,15070,1696,43890,2017,Jan
2017-01,Oklahoma,0,10811,8883,1004,20698,2017,Jan
2017-01,Oregon,1097,12071,8985,0,21056,2017,Jan
2017-01,Pennsylvania,30105,44199,10689,50,54938,2017,Jan
2017-01,Puerto Rico,0,1072,181,50,1303,2017,Jan
2017-01,Rhode Island,0,1196,687,78,1961,2017,Jan
2017-01,South Carolina,13868,9374,5678,788,15840,2017,Jan
2017-01,South Dakota,1695,2371,2803,303,5477,2017,Jan
2017-01,Tennessee,45857,23009,13583,1109,37701,2017,Jan
2017-01,Texas,28501,42697,31314,3040,77051,2017,Jan
2017-01,Utah,11312,3031,2961,233,6225,2017,Jan
2017-01,Vermont,0,1338,1214,74,2626,2017,Jan
2017-01,Virgin Islands,61,17,9,0,26,2017,Jan
2017-01,Virginia,846,21375,14319,820,36514,2017,Jan
2017-01,Washington,14089,15595,9913,1897,27405,2017,Jan
2017-01,West Virginia,2063,5837,4995,272,11104,2017,Jan
2017-01,Wisconsin,24323,12346,8888,758,21992,2017,Jan
2017-01,Wyoming,449,1329,1433,109,2871,2017,Jan
2016-12,Alabama,26996,13733,17519,376,31628,2016,Dec
2016-12,Alaska,254,4087,3698,243,8028,2016,Dec
2016-12,Arizona,8900,18024,13785,1180,32989,2016,Dec
2016-12,Arkansas,3294,9192,13433,277,22902,2016,Dec
2016-12,California,61808,63649,93224,77929,234802,2016,Dec
2016-12,Colorado,5333,25905,21134,1428,48467,2016,Dec
2016-12,Connecticut,6527,8003,3153,119,11275,2016,Dec
2016-12,Delaware,320,2689,2981,126,5796,2016,Dec
2016-12,District of Columbia,4,60,5,0,65,2016,Dec
2016-12,Florida,24096,69842,39880,3488,113210,2016,Dec
2016-12,Georgia,16891,23875,22613,598,47086,2016,Dec
2016-12,Guam,0,105,51,8,164,2016,Dec
2016-12,Hawaii,1139,0,0,0,0,2016,Dec
2016-12,Idaho,3292,5471,7074,206,12751,2016,Dec
2016-12,Illinois,17509,29658,17164,0,46822,2016,Dec
2016-12,Indiana,40729,30248,21688,1546,53482,2016,Dec
2016-12,Iowa,12486,391,4822,22,5235,2016,Dec
2016-12,Kansas,1368,8494,10473,450,19417,2016,Dec
2016-12,Kentucky,358510,17311,16766,371,34448,2016,Dec
2016-12,Louisiana,6268,18412,22848,992,42252,2016,Dec
2016-12,Maine,442,4641,4713,322,9676,2016,Dec
2016-12,Mariana Islands,0,0,0,0,0,2016,Dec
2016-12,Maryland,3687,4925,8870,211,14006,2016,Dec
2016-12,Massachusetts,8192,7050,3884,392,11326,2016,Dec
2016-12,Michigan,17469,14879,14328,550,29757,2016,Dec
2016-12,Minnesota,32841,12431,12851,930,26212,2016,Dec
2016-12,Mississippi,1771,13168,17231,366,30765,2016,Dec
2016-12,Missouri,1167,29770,27013,1507,58290,2016,Dec
2016-12,Montana,1408,3822,5832,164,9818,2016,Dec
2016-12,Nebraska,4704,268,3697,27,3992,2016,Dec
2016-12,Nevada,2216,6783,4696,313,11792,2016,Dec
2016-12,New Hampshire,3160,6625,4225,183,11033,2016,Dec
2016-12,New Jersey,0,5394,4979,204,10577,2016,Dec
2016-12,New Mexico,1079,7484,7149,467,15100,2016,Dec
2016-12,New York,2469,12074,22585,1029,35688,2016,Dec
2016-12,North Carolina,29463,2163,28023,907,31093,2016,Dec
2016-12,North Dakota,1189,1799,2927,108,4834,2016,Dec
2016-12,Ohio,11781,40996,29641,1877,72514,2016,Dec
2016-12,Oklahoma,0,17990,19418,1126,38534,2016,Dec
2016-12,Oregon,777,18931,16010,0,34941,2016,Dec
2016-12,Pennsylvania,28180,64220,18688,40,82948,2016,Dec
2016-12,Puerto Rico,0,1334,256,37,1627,2016,Dec
2016-12,Rhode Island,0,1283,953,72,2308,2016,Dec
2016-12,South Carolina,9634,15600,14782,809,31191,2016,Dec
2016-12,South Dakota,1238,3525,5131,299,8955,2016,Dec
2016-12,Tennessee,5124,36917,30997,1807,69721,2016,Dec
2016-12,Texas,24494,69163,69272,3641,142076,2016,Dec
2016-12,Utah,12544,6428,9257,341,16026,2016,Dec
2016-12,Vermont,0,1802,1998,99,3899,2016,Dec
2016-12,Virgin Islands,47,15,5,0,20,2016,Dec
2016-12,Virginia,1145,32572,27619,1308,61499,2016,Dec
2016-12,Washington,14178,21835,16484,1949,40268,2016,Dec
2016-12,West Virginia,1465,10869,11628,338,22835,2016,Dec
2016-12,Wisconsin,24129,16521,15036,818,32375,2016,Dec
2016-12,Wyoming,437,2540,2984,110,5634,2016,Dec
2016-11,Alabama,22628,10214,13470,388,24072,2016,Nov
2016-11,Alaska,254,3396,4019,316,7731,2016,Nov
2016-11,Arizona,8398,14850,11994,1288,28132,2016,Nov
2016-11,Arkansas,2755,7226,11866,268,19360,2016,Nov
2016-11,California,53278,56932,82554,30133,169619,2016,Nov
2016-11,Colorado,7129,24052,19794,1658,45504,2016,Nov
2016-11,Connecticut,6766,7063,3258,135,10456,2016,Nov
2016-11,Delaware,261,2490,2751,124,5365,2016,Nov
2016-11,District of Columbia,1,49,5,0,54,2016,Nov
2016-11,Florida,25377,62351,35718,3676,101745,2016,Nov
2016-11,Georgia,19019,18011,16759,556,35326,2016,Nov
2016-11,Guam,0,104,54,14,172,2016,Nov
2016-11,Hawaii,1347,0,0,0,0,2016,Nov
2016-11,Idaho,1660,4711,6175,325,11211,2016,Nov
2016-11,Illinois,26250,28463,19005,0,47468,2016,Nov
2016-11,Indiana,40805,25246,23336,1521,50103,2016,Nov
2016-11,Iowa,12788,399,5112,38,5549,2016,Nov
2016-11,Kansas,2459,8136,9854,537,18527,2016,Nov
2016-11,Kentucky,297507,12847,14844,329,28020,2016,Nov
2016-11,Louisiana,2928,14674,18349,938,33961,2016,Nov
2016-11,Maine,533,4135,5097,283,9515,2016,Nov
2016-11,Mariana Islands,0,0,4,0,4,2016,Nov
2016-11,Maryland,2214,5356,9509,220,15085,2016,Nov
2016-11,Massachusetts,9009,7117,4783,350,12250,2016,Nov
2016-11,Michigan,20528,15803,18241,656,34700,2016,Nov
2016-11,Minnesota,32676,12338,15597,907,28842,2016,Nov
2016-11,Mississippi,2052,9382,13481,356,23219,2016,Nov
2016-11,Missouri,1504,23719,26338,1473,51530,2016,Nov
2016-11,Montana,1621,3093,5546,233,8872,2016,Nov
2016-11,Nebraska,5008,216,3688,22,3926,2016,Nov
2016-11,Nevada,2595,6338,4291,352,10981,2016,Nov
2016-11,New Hampshire,3814,6283,4822,237,11342,2016,Nov
2016-11,New Jersey,0,5398,5720,199,11317,2016,Nov
2016-11,New Mexico,1019,6153,6034,490,12677,2016,Nov
2016-11,New York,3702,11157,25229,1245,37631,2016,Nov
2016-11,North Carolina,29034,1709,23215,939,25863,2016,Nov
2016-11,North Dakota,720,1827,3546,104,5477,2016,Nov
2016-11,Ohio,12670,37304,32312,1977,71593,2016,Nov
2016-11,Oklahoma,0,16348,17019,1274,34641,2016,Nov
2016-11,Oregon,831,17013,15711,0,32724,2016,Nov
2016-11,Pennsylvania,30800,66188,20487,42,86717,2016,Nov
2016-11,Puerto Rico,0,1323,204,26,1553,2016,Nov
2016-11,Rhode Island,0,1271,1065,94,2430,2016,Nov
2016-11,South Carolina,12216,12839,11547,616,25002,2016,Nov
2016-11,South Dakota,1501,3456,5677,374,9507,2016,Nov
2016-11,Tennessee,17474,29502,25976,1719,57197,2016,Nov
2016-11,Texas,23199,58778,56057,3610,118445,2016,Nov
2016-11,Utah,13500,5232,7021,374,12627,2016,Nov
2016-11,Vermont,0,1342,1975,109,3426,2016,Nov
2016-11,Virgin Islands,54,17,5,0,22,2016,Nov
2016-11,Virginia,695,29544,26823,1298,57665,2016,Nov
2016-11,Washington,13926,19534,16266,2243,38043,2016,Nov
2016-11,West Virginia,1786,7824,11134,333,19291,2016,Nov
2016-11,Wisconsin,26474,17580,19631,883,38094,2016,Nov
2016-11,Wyoming,393,2097,2691,136,4924,2016,Nov
2016-10,Alabama,22979,7757,8865,403,17025,2016,Oct
2016-10,Alaska,336,3906,3949,347,8202,2016,Oct
2016-10,Arizona,8072,12405,9382,1224,23011,2016,Oct
2016-10,Arkansas,4005,5607,8235,309,14151,2016,Oct
2016-10,California,60578,45785,54333,19226,119344,2016,Oct
2016-10,Colorado,4751,20343,16962,1701,39006,2016,Oct
2016-10,Connecticut,6827,6374,2698,148,9220,2016,Oct
2016-10,Delaware,1317,2070,2082,119,4271,2016,Oct
2016-10,District of Columbia,0,59,2,0,61,2016,Oct
2016-10,Florida,23891,50003,27010,3908,80921,2016,Oct
2016-10,Georgia,17189,13799,12262,592,26653,2016,Oct
2016-10,Guam,0,127,72,17,216,2016,Oct
2016-10,Hawaii,1268,0,0,0,0,2016,Oct
2016-10,Idaho,2895,3913,5787,270,9970,2016,Oct
2016-10,Illinois,20563,33986,14739,0,48725,2016,Oct
2016-10,Indiana,30950,21058,16857,1725,39640,2016,Oct
2016-10,Iowa,10955,221,3557,25,3803,2016,Oct
2016-10,Kansas,2283,6527,6775,534,13836,2016,Oct
2016-10,Kentucky,354387,10111,10030,354,20495,2016,Oct
2016-10,Louisiana,3103,11865,13673,1043,26581,2016,Oct
2016-10,Maine,567,4320,6926,319,11565,2016,Oct
2016-10,Mariana Islands,0,0,1,0,1,2016,Oct
2016-10,Maryland,2866,4280,6786,180,11246,2016,Oct
2016-10,Massachusetts,8761,6415,3680,344,10439,2016,Oct
2016-10,Michigan,18470,12680,13539,618,26837,2016,Oct
2016-10,Minnesota,38403,11394,18553,1024,30971,2016,Oct
2016-10,Mississippi,2004,7564,8323,350,16237,2016,Oct
2016-10,Missouri,1921,21994,20919,1633,44546,2016,Oct
2016-10,Montana,1523,3035,6689,213,9937,2016,Oct
2016-10,Nebraska,4705,144,2817,24,2985,2016,Oct
2016-10,Nevada,1726,5614,3471,350,9435,2016,Oct
2016-10,New Hampshire,4062,5968,4672,258,10898,2016,Oct
2016-10,New Jersey,0,5391,4567,217,10175,2016,Oct
2016-10,New Mexico,883,5449,4826,470,10745,2016,Oct
2016-10,New York,3941,10820,21094,1117,33031,2016,Oct
2016-10,North Carolina,26407,1353,15980,1042,18375,2016,Oct
2016-10,North Dakota,676,1674,4451,125,6250,2016,Oct
2016-10,Ohio,12693,30593,21991,2592,55176,2016,Oct
2016-10,Oklahoma,0,11560,11325,1127,24012,2016,Oct
2016-10,Oregon,787,14749,13412,0,28161,2016,Oct
2016-10,Pennsylvania,29248,56836,16223,40,73099,2016,Oct
2016-10,Puerto Rico,0,1165,194,40,1399,2016,Oct
2016-10,Rhode Island,0,1162,950,94,2206,2016,Oct
2016-10,South Carolina,11817,9270,7797,598,17665,2016,Oct
2016-10,South Dakota,1629,3127,6859,368,10354,2016,Oct
2016-10,Tennessee,12980,23542,18514,1485,43541,2016,Oct
2016-10,Texas,34700,46518,44519,3763,94800,2016,Oct
2016-10,Utah,13883,3588,4603,345,8536,2016,Oct
2016-10,Vermont,0,1485,2099,99,3683,2016,Oct
2016-10,Virgin Islands,37,16,13,0,29,2016,Oct
2016-10,Virginia,816,24337,20433,1269,46039,2016,Oct
2016-10,Washington,15570,18601,15455,2650,36706,2016,Oct
2016-10,West Virginia,1937,6721,7737,353,14811,2016,Oct
2016-10,Wisconsin,28980,15514,17376,946,33836,2016,Oct
2016-10,Wyoming,534,1709,2307,127,4143,2016,Oct
2016-09,Alabama,22014,7125,8449,319,15893,2016,Sep
2016-09,Alaska,306,2654,3126,180,5960,2016,Sep
2016-09,Arizona,8641,11769,8951,1086,21806,2016,Sep
2016-09,Arkansas,3300,4802,6284,231,11317,2016,Sep
2016-09,California,62196,39213,43015,13548,95776,2016,Sep
2016-09,Colorado,5593,17390,14521,1143,33054,2016,Sep
2016-09,Connecticut,6953,5424,2472,104,8000,2016,Sep
2016-09,Delaware,291,1759,1894,76,3729,2016,Sep
2016-09,District of Columbia,0,46,4,0,50,2016,Sep
2016-09,Florida,24431,45848,22439,3359,71646,2016,Sep
2016-09,Georgia,14745,12258,9766,456,22480,2016,Sep
2016-09,Guam,0,99,63,25,187,2016,Sep
2016-09,Hawaii,1237,0,0,0,0,2016,Sep
2016-09,Idaho,2726,3124,5230,234,8588,2016,Sep
2016-09,Illinois,17365,20298,11876,0,32174,2016,Sep
2016-09,Indiana,30423,17402,13402,1291,32095,2016,Sep
2016-09,Iowa,9095,154,2694,26,2874,2016,Sep
2016-09,Kansas,1748,4903,5614,371,10888,2016,Sep
2016-09,Kentucky,276744,8917,8172,257,17346,2016,Sep
2016-09,Louisiana,2914,12875,13747,768,27390,2016,Sep
2016-09,Maine,660,3841,5203,222,9266,2016,Sep
2016-09,Mariana Islands,0,0,1,0,1,2016,Sep
2016-09,Maryland,2659,3626,5428,135,9189,2016,Sep
2016-09,Massachusetts,8095,5584,3210,327,9121,2016,Sep
2016-09,Michigan,15152,10056,11311,477,21844,2016,Sep
2016-09,Minnesota,30783,9548,16213,695,26456,2016,Sep
2016-09,Mississippi,2554,6904,6592,276,13772,2016,Sep
2016-09,Missouri,2907,17808,15528,1323,34659,2016,Sep
2016-09,Montana,1355,2702,5404,167,8273,2016,Sep
2016-09,Nebraska,3682,104,2144,19,2267,2016,Sep
2016-09,Nevada,2386,4281,2764,262,7307,2016,Sep
2016-09,New Hampshire,4131,5100,3766,184,9050,2016,Sep
2016-09,New Jersey,0,5249,3864,196,9309,2016,Sep
2016-09,New Mexico,927,4793,4277,368,9438,2016,Sep
2016-09,New York,4362,9700,17804,884,28388,2016,Sep
2016-09,North Carolina,25994,1068,14018,722,15808,2016,Sep
2016-09,North Dakota,819,1273,3381,99,4753,2016,Sep
2016-09,Ohio,11166,24297,18038,1573,43908,2016,Sep
2016-09,Oklahoma,0,9638,10003,860,20501,2016,Sep
2016-09,Oregon,114,13325,13046,0,26371,2016,Sep
2016-09,Pennsylvania,26936,46101,12697,31,58829,2016,Sep
2016-09,Puerto Rico,0,1110,213,28,1351,2016,Sep
2016-09,Rhode Island,0,1031,767,62,1860,2016,Sep
2016-09,South Carolina,10337,8725,7088,483,16296,2016,Sep
2016-09,South Dakota,1335,2530,4663,178,7371,2016,Sep
2016-09,Tennessee,11512,20721,15120,0,35841,2016,Sep
2016-09,Texas,29142,37858,42308,2888,83054,2016,Sep
2016-09,Utah,11262,2918,4440,278,7636,2016,Sep
2016-09,Vermont,0,1233,1701,96,3030,2016,Sep
2016-09,Virgin Islands,42,25,7,0,32,2016,Sep
2016-09,Virginia,804,20325,16687,954,37966,2016,Sep
2016-09,Washington,12021,15261,13621,2203,31085,2016,Sep
2016-09,West Virginia,1686,6122,6495,256,12873,2016,Sep
2016-09,Wisconsin,30268,13271,14796,691,28758,2016,Sep
2016-09,Wyoming,699,1521,2207,90,3818,2016,Sep
2016-08,Alabama,22987,8243,7808,352,16403,2016,Aug
2016-08,Alaska,183,2725,3484,183,6392,2016,Aug
2016-08,Arizona,8752,12069,8601,1084,21754,2016,Aug
2016-08,Arkansas,5990,5666,6108,207,11981,2016,Aug
2016-08,California,75535,43344,43552,13186,100082,2016,Aug
2016-08,Colorado,6238,18116,14054,1204,33374,2016,Aug
2016-08,Connecticut,13217,9929,3941,230,14100,2016,Aug
2016-08,Delaware,705,1662,1562,96,3320,2016,Aug
2016-08,District of Columbia,2,56,3,0,59,2016,Aug
2016-08,Florida,31652,49867,23359,3572,76798,2016,Aug
2016-08,Georgia,18136,12627,9187,556,22370,2016,Aug
2016-08,Guam,0,95,54,16,165,2016,Aug
2016-08,Hawaii,1298,0,0,0,0,2016,Aug
2016-08,Idaho,2919,3194,4214,177,7585,2016,Aug
2016-08,Illinois,17735,60745,30602,0,91347,2016,Aug
2016-08,Indiana,44252,18906,13606,1238,33750,2016,Aug
2016-08,Iowa,9861,182,2345,22,2549,2016,Aug
2016-08,Kansas,1581,4987,5437,404,10828,2016,Aug
2016-08,Kentucky,9579,8842,7187,281,16310,2016,Aug
2016-08,Louisiana,3231,13082,10527,971,24580,2016,Aug
2016-08,Maine,615,3294,3546,239,7079,2016,Aug
2016-08,Mariana Islands,0,0,2,1,3,2016,Aug
2016-08,Maryland,2761,4249,5109,89,9447,2016,Aug
2016-08,Massachusetts,8977,5601,2915,340,8856,2016,Aug
2016-08,Michigan,16743,10650,9117,458,20225,2016,Aug
2016-08,Minnesota,28620,9391,11884,694,21969,2016,Aug
2016-08,Mississippi,2524,11193,9085,412,20690,2016,Aug
2016-08,Missouri,5318,18394,15365,1418,35177,2016,Aug
2016-08,Montana,1483,2882,4487,162,7531,2016,Aug
2016-08,Nebraska,4257,126,1805,19,1950,2016,Aug
2016-08,Nevada,2256,4676,2629,246,7551,2016,Aug
2016-08,New Hampshire,3629,4732,3421,182,8335,2016,Aug
2016-08,New Jersey,0,5541,3962,225,9728,2016,Aug
2016-08,New Mexico,1141,5170,4224,316,9710,2016,Aug
2016-08,New York,4135,10716,14278,961,25955,2016,Aug
2016-08,North Carolina,28076,1208,12513,755,14476,2016,Aug
2016-08,North Dakota,1216,1284,2601,92,3977,2016,Aug
2016-08,Ohio,13656,26261,17526,1626,45413,2016,Aug
2016-08,Oklahoma,0,10881,9762,1008,21651,2016,Aug
2016-08,Oregon,71,12661,10173,0,22834,2016,Aug
2016-08,Pennsylvania,27897,46155,11700,4,57859,2016,Aug
2016-08,Puerto Rico,0,1073,234,21,1328,2016,Aug
2016-08,Rhode Island,0,1039,770,104,1913,2016,Aug
2016-08,South Carolina,13000,8828,6906,494,16228,2016,Aug
2016-08,South Dakota,1259,2387,3559,202,6148,2016,Aug
2016-08,Tennessee,18828,22737,16198,0,38935,2016,Aug
2016-08,Texas,25803,42302,40269,3137,85708,2016,Aug
2016-08,Utah,13405,2917,3503,277,6697,2016,Aug
2016-08,Vermont,0,1269,1296,108,2673,2016,Aug
2016-08,Virgin Islands,55,29,6,0,35,2016,Aug
2016-08,Virginia,776,21108,15802,978,37888,2016,Aug
2016-08,Washington,14063,15083,11376,1622,28081,2016,Aug
2016-08,West Virginia,1948,6916,5283,243,12442,2016,Aug
2016-08,Wisconsin,25551,14764,12079,709,27552,2016,Aug
2016-08,Wyoming,906,1721,2079,105,3905,2016,Aug
2016-07,Alabama,27765,10132,7392,538,18062,2016,Jul
2016-07,Alaska,215,2898,2816,239,5953,2016,Jul
2016-07,Arizona,7863,13693,8643,1283,23619,2016,Jul
2016-07,Arkansas,4116,6323,5053,325,11701,2016,Jul
2016-07,California,77962,46361,47594,17297,111252,2016,Jul
2016-07,Colorado,6372,18765,15176,1505,35446,2016,Jul
2016-07,Connecticut,14156,11328,4015,252,15595,2016,Jul
2016-07,Delaware,755,1859,1569,140,3568,2016,Jul
2016-07,District of Columbia,0,57,1,0,58,2016,Jul
2016-07,Florida,28106,57902,28000,4504,90406,2016,Jul
2016-07,Georgia,20555,15342,8597,635,24574,2016,Jul
2016-07,Guam,0,94,56,16,166,2016,Jul
2016-07,Hawaii,1563,0,0,0,0,2016,Jul
2016-07,Idaho,3606,3592,3576,247,7415,2016,Jul
2016-07,Illinois,125075,21421,11881,0,33302,2016,Jul
2016-07,Indiana,53844,19508,12191,1600,33299,2016,Jul
2016-07,Iowa,9391,186,2227,27,2440,2016,Jul
2016-07,Kansas,1320,6075,4942,462,11479,2016,Jul
2016-07,Kentucky,342858,9378,6615,321,16314,2016,Jul
2016-07,Louisiana,2595,21637,12252,1453,35342,2016,Jul
2016-07,Maine,540,3426,3026,266,6718,2016,Jul
2016-07,Mariana Islands,0,0,1,0,1,2016,Jul
2016-07,Maryland,2383,3973,5505,105,9583,2016,Jul
2016-07,Massachusetts,7091,6257,5108,1498,12863,2016,Jul
2016-07,Michigan,15869,11308,8095,510,19913,2016,Jul
2016-07,Minnesota,22422,9743,9207,913,19863,2016,Jul
2016-07,Mississippi,1913,10425,6125,436,16986,2016,Jul
2016-07,Missouri,6903,20791,13575,1698,36064,2016,Jul
2016-07,Montana,1356,2894,3882,218,6994,2016,Jul
2016-07,Nebraska,3629,93,1529,27,1649,2016,Jul
2016-07,Nevada,2497,5194,3006,328,8528,2016,Jul
2016-07,New Hampshire,3882,5200,3716,181,9097,2016,Jul
2016-07,New Jersey,0,5708,4155,211,10074,2016,Jul
2016-07,New Mexico,1103,5380,3966,475,9821,2016,Jul
2016-07,New York,3738,10900,13073,1131,25104,2016,Jul
2016-07,North Carolina,25408,1157,12487,1025,14669,2016,Jul
2016-07,North Dakota,1305,1333,2457,116,3906,2016,Jul
2016-07,Ohio,11762,27876,17720,2166,47762,2016,Jul
2016-07,Oklahoma,0,11750,8792,1139,21681,2016,Jul
2016-07,Oregon,21,14284,10507,0,24791,2016,Jul
2016-07,Pennsylvania,26819,46843,11793,19,58655,2016,Jul
2016-07,Puerto Rico,0,1038,234,31,1303,2016,Jul
2016-07,Rhode Island,0,1133,951,101,2185,2016,Jul
2016-07,South Carolina,14025,9967,5880,707,16554,2016,Jul
2016-07,South Dakota,1179,2490,3004,277,5771,2016,Jul
2016-07,Tennessee,1915,26276,16118,0,42394,2016,Jul
2016-07,Texas,24634,50499,34266,4046,88811,2016,Jul
2016-07,Utah,9754,3381,3328,276,6985,2016,Jul
2016-07,Vermont,0,1293,1201,117,2611,2016,Jul
2016-07,Virgin Islands,81,21,2,0,23,2016,Jul
2016-07,Virginia,1102,24671,16731,1064,42466,2016,Jul
2016-07,Washington,14111,15652,11536,2118,29306,2016,Jul
2016-07,West Virginia,1992,6417,5134,313,11864,2016,Jul
2016-07,Wisconsin,14505,13182,9870,847,23899,2016,Jul
2016-07,Wyoming,597,1619,1769,131,3519,2016,Jul
2016-06,Alabama,24802,9146,7273,555,16974,2016,Jun
2016-06,Alaska,290,2987,3204,286,6477,2016,Jun
2016-06,Arizona,6371,12942,8614,1345,22901,2016,Jun
2016-06,Arkansas,5233,5454,4574,330,10358,2016,Jun
2016-06,California,81628,43042,37512,10673,91227,2016,Jun
2016-06,Colorado,5283,17790,15115,1676,34581,2016,Jun
2016-06,Connecticut,17183,12011,3974,307,16292,2016,Jun
2016-06,Delaware,1188,1842,1621,125,3588,2016,Jun
2016-06,District of Columbia,23,46,3,0,49,2016,Jun
2016-06,Florida,28462,55934,29501,5096,90531,2016,Jun
2016-06,Georgia,16995,13307,7859,649,21815,2016,Jun
2016-06,Guam,0,104,50,7,161,2016,Jun
2016-06,Hawaii,1743,0,0,0,0,2016,Jun
2016-06,Idaho,4079,3445,4143,282,7870,2016,Jun
2016-06,Illinois,128545,22277,12787,0,35064,2016,Jun
2016-06,Indiana,61071,18307,11949,1831,32087,2016,Jun
2016-06,Iowa,9899,129,2004,76,2209,2016,Jun
2016-06,Kansas,890,5275,4447,523,10245,2016,Jun
2016-06,Kentucky,340735,8703,6584,438,15725,2016,Jun
2016-06,Louisiana,2088,12082,8428,1161,21671,2016,Jun
2016-06,Maine,763,3433,2943,301,6677,2016,Jun
2016-06,Mariana Islands,0,0,1,0,1,2016,Jun
2016-06,Maryland,2132,4288,4864,138,9290,2016,Jun
2016-06,Massachusetts,7045,5965,3404,990,10359,2016,Jun
2016-06,Michigan,15883,10335,8282,616,19233,2016,Jun
2016-06,Minnesota,27062,8880,9723,1215,19818,2016,Jun
2016-06,Mississippi,1996,7804,4692,346,12842,2016,Jun
2016-06,Missouri,7958,18770,13295,1813,33878,2016,Jun
2016-06,Montana,1614,2968,4379,234,7581,2016,Jun
2016-06,Nebraska,3890,107,1609,15,1731,2016,Jun
2016-06,Nevada,2645,4949,3114,358,8421,2016,Jun
2016-06,New Hampshire,3728,5166,3453,196,8815,2016,Jun
2016-06,New Jersey,0,6266,4294,246,10806,2016,Jun
2016-06,New Mexico,1202,5336,4231,531,10098,2016,Jun
2016-06,New York,4257,10062,12213,1205,23480,2016,Jun
2016-06,North Carolina,26567,1181,11749,943,13873,2016,Jun
2016-06,North Dakota,2462,1312,2377,164,3853,2016,Jun
2016-06,Ohio,13236,24397,17086,2294,43777,2016,Jun
2016-06,Oklahoma,0,11933,8811,1415,22159,2016,Jun
2016-06,Oregon,48,14054,11400,0,25454,2016,Jun
2016-06,Pennsylvania,23639,44677,11841,35,56553,2016,Jun
2016-06,Puerto Rico,0,1025,214,36,1275,2016,Jun
2016-06,Rhode Island,0,1146,862,85,2093,2016,Jun
2016-06,South Carolina,12286,9619,5599,680,15898,2016,Jun
2016-06,South Dakota,1155,2460,3139,309,5908,2016,Jun
2016-06,Tennessee,2123,22476,15194,0,37670,2016,Jun
2016-06,Texas,23267,46816,33501,4013,84330,2016,Jun
2016-06,Utah,19677,3433,3731,311,7475,2016,Jun
2016-06,Vermont,0,1240,1225,131,2596,2016,Jun
2016-06,Virgin Islands,74,24,7,0,31,2016,Jun
2016-06,Virginia,985,20132,15480,993,36605,2016,Jun
2016-06,Washington,13202,17040,13267,2576,32883,2016,Jun
2016-06,West Virginia,1822,6602,4821,375,11798,2016,Jun
2016-06,Wisconsin,5459,12464,11144,1173,24781,2016,Jun
2016-06,Wyoming,509,1638,2110,123,3871,2016,Jun
2016-05,Alabama,20092,7903,5256,254,13413,2016,May
2016-05,Alaska,253,2582,2391,190,5163,2016,May
2016-05,Arizona,6941,10994,6539,880,18413,2016,May
2016-05,Arkansas,5452,4551,3596,137,8284,2016,May
2016-05,California,91841,38301,28723,6124,73148,2016,May
2016-05,Colorado,6924,16293,11252,934,28479,2016,May
2016-05,Connecticut,15718,9953,3362,212,13527,2016,May
2016-05,Delaware,1255,1722,1121,66,2909,2016,May
2016-05,District of Columbia,57,47,6,0,53,2016,May
2016-05,Florida,27235,42845,17025,2625,62495,2016,May
2016-05,Georgia,13787,10866,5510,361,16737,2016,May
2016-05,Guam,0,119,56,8,183,2016,May
2016-05,Hawaii,1314,0,0,0,0,2016,May
2016-05,Idaho,1139,3132,3323,149,6604,2016,May
2016-05,Illinois,91026,19264,8686,0,27950,2016,May
2016-05,Indiana,91807,16842,9264,965,27071,2016,May
2016-05,Iowa,10729,121,1569,16,1706,2016,May
2016-05,Kansas,1006,4648,3553,281,8482,2016,May
2016-05,Kentucky,305018,8049,5244,222,13515,2016,May
2016-05,Louisiana,2376,9561,5788,668,16017,2016,May
2016-05,Maine,568,3009,2464,142,5615,2016,May
2016-05,Mariana Islands,0,0,1,0,1,2016,May
2016-05,Maryland,2567,4099,4148,130,8377,2016,May
2016-05,Massachusetts,7114,5278,2325,486,8089,2016,May
2016-05,Michigan,18750,9834,6490,344,16668,2016,May
2016-05,Minnesota,24146,8772,7638,637,17047,2016,May
2016-05,Mississippi,1981,7005,3541,215,10761,2016,May
2016-05,Missouri,9606,16909,10162,966,28037,2016,May
2016-05,Montana,1490,2724,3881,123,6728,2016,May
2016-05,Nebraska,3394,78,1277,9,1364,2016,May
2016-05,Nevada,2624,4365,2329,191,6885,2016,May
2016-05,New Hampshire,3719,4262,2645,137,7044,2016,May
2016-05,New Jersey,0,6542,3027,201,9770,2016,May
2016-05,New Mexico,1666,4485,3269,327,8081,2016,May
2016-05,New York,4053,10118,10815,684,21617,2016,May
2016-05,North Carolina,25228,1119,8506,518,10143,2016,May
2016-05,North Dakota,1319,1186,1798,85,3069,2016,May
2016-05,Ohio,14797,26069,13219,1435,40723,2016,May
2016-05,Oklahoma,0,10385,6490,779,17654,2016,May
2016-05,Oregon,28,12038,9194,0,21232,2016,May
2016-05,Pennsylvania,20806,39963,8770,23,48756,2016,May
2016-05,Puerto Rico,0,991,166,24,1181,2016,May
2016-05,Rhode Island,0,936,536,28,1500,2016,May
2016-05,South Carolina,11329,7570,3922,363,11855,2016,May
2016-05,South Dakota,922,2161,2666,191,5018,2016,May
2016-05,Tennessee,2564,19232,10394,0,29626,2016,May
2016-05,Texas,25496,39446,25424,2559,67429,2016,May
2016-05,Utah,16748,3097,3067,235,6399,2016,May
2016-05,Vermont,0,1096,1026,62,2184,2016,May
2016-05,Virgin Islands,84,26,2,0,28,2016,May
2016-05,Virginia,943,18183,10896,758,29837,2016,May
2016-05,Washington,12459,14601,9033,1334,24968,2016,May
2016-05,West Virginia,1939,6099,4179,232,10510,2016,May
2016-05,Wisconsin,6549,11438,8481,562,20481,2016,May
2016-05,Wyoming,868,1497,1671,97,3265,2016,May
2016-04,Alabama,20959,9742,6977,320,17039,2016,Apr
2016-04,Alaska,298,3036,2777,178,5991,2016,Apr
2016-04,Arizona,7230,13086,7278,885,21249,2016,Apr
2016-04,Arkansas,5825,5334,4513,193,10040,2016,Apr
2016-04,California,93023,41862,30133,5247,77242,2016,Apr
2016-04,Colorado,8900,17897,12560,1048,31505,2016,Apr
2016-04,Connecticut,16609,11882,3936,229,16047,2016,Apr
2016-04,Delaware,848,1878,1313,72,3263,2016,Apr
2016-04,District of Columbia,11,55,3,0,58,2016,Apr
2016-04,Florida,27570,48697,19716,2788,71201,2016,Apr
2016-04,Georgia,16847,13673,6764,385,20822,2016,Apr
2016-04,Guam,0,100,45,8,153,2016,Apr
2016-04,Hawaii,1452,0,0,0,0,2016,Apr
2016-04,Idaho,2400,3376,3720,179,7275,2016,Apr
2016-04,Illinois,117410,24894,11132,0,36026,2016,Apr
2016-04,Indiana,91355,20756,12137,1079,33972,2016,Apr
2016-04,Iowa,12650,184,2453,27,2664,2016,Apr
2016-04,Kansas,1392,5785,4540,333,10658,2016,Apr
2016-04,Kentucky,285372,9657,7070,223,16950,2016,Apr
2016-04,Louisiana,2192,11703,6552,685,18940,2016,Apr
2016-04,Maine,656,3970,3254,184,7408,2016,Apr
2016-04,Mariana Islands,0,0,0,0,0,2016,Apr
2016-04,Maryland,3361,4294,4966,145,9405,2016,Apr
2016-04,Massachusetts,7414,6227,3009,594,9830,2016,Apr
2016-04,Michigan,24885,13598,8647,445,22690,2016,Apr
2016-04,Minnesota,30337,12547,12295,809,25651,2016,Apr
2016-04,Mississippi,1416,8765,4139,263,13167,2016,Apr
2016-04,Missouri,12050,19787,12754,970,33511,2016,Apr
2016-04,Montana,1771,2989,4388,133,7510,2016,Apr
2016-04,Nebraska,4353,116,1650,18,1784,2016,Apr
2016-04,Nevada,2958,5135,2793,223,8151,2016,Apr
2016-04,New Hampshire,3602,5337,3400,139,8876,2016,Apr
2016-04,New Jersey,0,6887,3331,247,10465,2016,Apr
2016-04,New Mexico,1619,5311,3967,294,9572,2016,Apr
2016-04,New York,4181,11281,14660,881,26822,2016,Apr
2016-04,North Carolina,27505,1250,10280,607,12137,2016,Apr
2016-04,North Dakota,765,2083,2791,89,4963,2016,Apr
2016-04,Ohio,16083,32959,17664,1618,52241,2016,Apr
2016-04,Oklahoma,0,13132,8302,915,22349,2016,Apr
2016-04,Oregon,24,13102,9998,0,23100,2016,Apr
2016-04,Pennsylvania,24297,51472,11628,15,63115,2016,Apr
2016-04,Puerto Rico,0,947,202,17,1166,2016,Apr
2016-04,Rhode Island,0,1149,746,35,1930,2016,Apr
2016-04,South Carolina,14347,9617,4618,391,14626,2016,Apr
2016-04,South Dakota,1114,2981,3412,218,6611,2016,Apr
2016-04,Tennessee,4151,22965,12049,0,35014,2016,Apr
2016-04,Texas,38061,45339,27823,2775,75937,2016,Apr
2016-04,Utah,22419,3560,3646,230,7436,2016,Apr
2016-04,Vermont,0,1483,1557,90,3130,2016,Apr
2016-04,Virgin Islands,59,23,3,0,26,2016,Apr
2016-04,Virginia,415,21709,13235,851,35795,2016,Apr
2016-04,Washington,34121,15988,9698,1415,27101,2016,Apr
2016-04,West Virginia,2323,6908,5417,249,12574,2016,Apr
2016-04,Wisconsin,8256,15693,13348,673,29714,2016,Apr
2016-04,Wyoming,785,1764,1952,104,3820,2016,Apr
2016-03,Alabama,27829,14372,9115,383,23870,2016,Mar
2016-03,Alaska,256,3171,2750,209,6130,2016,Mar
2016-03,Arizona,8078,14387,7907,883,23177,2016,Mar
2016-03,Arkansas,7649,7603,5448,219,13270,2016,Mar
2016-03,California,117206,45266,31454,6007,82727,2016,Mar
2016-03,Colorado,11129,20049,12776,1069,33894,2016,Mar
2016-03,Connecticut,16727,13996,4388,198,18582,2016,Mar
2016-03,Delaware,690,2353,1611,83,4047,2016,Mar
2016-03,District of Columbia,5,74,6,0,80,2016,Mar
2016-03,Florida,34627,54164,22000,2874,79038,2016,Mar
2016-03,Georgia,24301,18272,8517,467,27256,2016,Mar
2016-03,Guam,0,115,58,8,181,2016,Mar
2016-03,Hawaii,1468,0,0,0,0,2016,Mar
2016-03,Idaho,4411,3925,4208,227,8360,2016,Mar
2016-03,Illinois,132757,29052,12971,0,42023,2016,Mar
2016-03,Indiana,107510,27883,13485,1472,42840,2016,Mar
2016-03,Iowa,20031,252,3012,25,3289,2016,Mar
2016-03,Kansas,1857,7683,5368,409,13460,2016,Mar
2016-03,Kentucky,294755,13816,8391,283,22490,2016,Mar
2016-03,Louisiana,1937,13738,7553,799,22090,2016,Mar
2016-03,Maine,704,4725,3320,232,8277,2016,Mar
2016-03,Mariana Islands,0,0,1,0,1,2016,Mar
2016-03,Maryland,3898,4866,5363,157,10386,2016,Mar
2016-03,Massachusetts,9327,7019,3275,546,10840,2016,Mar
2016-03,Michigan,30175,18316,10145,495,28956,2016,Mar
2016-03,Minnesota,29378,13738,11323,797,25858,2016,Mar
2016-03,Mississippi,1740,11287,5697,331,17315,2016,Mar
2016-03,Missouri,17076,27030,15359,1257,43646,2016,Mar
2016-03,Montana,2372,3305,4621,150,8076,2016,Mar
2016-03,Nebraska,6108,132,1944,16,2092,2016,Mar
2016-03,Nevada,3373,6116,3062,231,9409,2016,Mar
2016-03,New Hampshire,4769,5912,3506,142,9560,2016,Mar
2016-03,New Jersey,0,7346,3582,210,11138,2016,Mar
2016-03,New Mexico,1165,6497,4466,388,11351,2016,Mar
2016-03,New York,5302,12474,15134,1041,28649,2016,Mar
2016-03,North Carolina,34897,1494,12263,673,14430,2016,Mar
2016-03,North Dakota,1208,1945,2711,97,4753,2016,Mar
2016-03,Ohio,19568,40331,19408,2179,61918,2016,Mar
2016-03,Oklahoma,0,14892,8975,958,24825,2016,Mar
2016-03,Oregon,69,15513,11510,0,27023,2016,Mar
2016-03,Pennsylvania,31577,60489,12299,0,72788,2016,Mar
2016-03,Puerto Rico,0,948,200,8,1156,2016,Mar
2016-03,Rhode Island,0,1411,858,57,2326,2016,Mar
2016-03,South Carolina,17408,12312,6138,446,18896,2016,Mar
2016-03,South Dakota,1448,3451,3588,236,7275,2016,Mar
2016-03,Tennessee,2578,27951,14909,0,42860,2016,Mar
2016-03,Texas,48497,55547,31794,2985,90326,2016,Mar
2016-03,Utah,21789,3772,3883,262,7917,2016,Mar
2016-03,Vermont,0,1941,1715,118,3774,2016,Mar
2016-03,Virgin Islands,67,19,3,0,22,2016,Mar
2016-03,Virginia,828,26264,14622,1019,41905,2016,Mar
2016-03,Washington,89199,19501,10947,1643,32091,2016,Mar
2016-03,West Virginia,3003,9481,6336,273,16090,2016,Mar
2016-03,Wisconsin,10344,18439,14836,807,34082,2016,Mar
2016-03,Wyoming,700,1995,2026,135,4156,2016,Mar
2016-02,Alabama,24746,29311,15054,950,45315,2016,Feb
2016-02,Alaska,284,3190,2428,218,5836,2016,Feb
2016-02,Arizona,4627,16820,8782,877,26479,2016,Feb
2016-02,Arkansas,4167,10532,7028,258,17818,2016,Feb
2016-02,California,134211,44461,29486,5283,79230,2016,Feb
2016-02,Colorado,9004,22384,13355,1050,36789,2016,Feb
2016-02,Connecticut,14261,13316,4250,275,17841,2016,Feb
2016-02,Delaware,415,2702,1633,131,4466,2016,Feb
2016-02,District of Columbia,14,74,7,0,81,2016,Feb
2016-02,Florida,33181,62770,25228,3069,91067,2016,Feb
2016-02,Georgia,24137,24534,10747,565,35846,2016,Feb
2016-02,Guam,0,85,44,8,137,2016,Feb
2016-02,Hawaii,1419,0,0,0,0,2016,Feb
2016-02,Idaho,4934,4419,4321,242,8982,2016,Feb
2016-02,Illinois,125089,30241,13543,0,43784,2016,Feb
2016-02,Indiana,170646,32373,14947,1625,48945,2016,Feb
2016-02,Iowa,20356,279,2859,45,3183,2016,Feb
2016-02,Kansas,1711,9407,6165,433,16005,2016,Feb
2016-02,Kentucky,229733,19243,10414,404,30061,2016,Feb
2016-02,Louisiana,2686,16474,9031,888,26393,2016,Feb
2016-02,Maine,438,5426,3234,228,8888,2016,Feb
2016-02,Mariana Islands,0,0,1,0,1,2016,Feb
2016-02,Maryland,4039,4368,5803,163,10334,2016,Feb
2016-02,Massachusetts,7944,6253,2838,562,9653,2016,Feb
2016-02,Michigan,29353,19778,10899,543,31220,2016,Feb
2016-02,Minnesota,25678,12754,9635,793,23182,2016,Feb
2016-02,Mississippi,1171,15296,7203,308,22807,2016,Feb
2016-02,Missouri,13121,30802,16707,1404,48913,2016,Feb
2016-02,Montana,2279,3779,4151,154,8084,2016,Feb
2016-02,Nebraska,6096,154,2078,27,2259,2016,Feb
2016-02,Nevada,3288,6643,3115,244,10002,2016,Feb
2016-02,New Hampshire,4044,6798,3464,156,10418,2016,Feb
2016-02,New Jersey,0,6007,3613,191,9811,2016,Feb
2016-02,New Mexico,1576,7455,5049,393,12897,2016,Feb
2016-02,New York,4971,11963,15324,1130,28417,2016,Feb
2016-02,North Carolina,33753,1543,14935,835,17313,2016,Feb
2016-02,North Dakota,761,2100,2419,99,4618,2016,Feb
2016-02,Ohio,16201,45459,20745,2196,68400,2016,Feb
2016-02,Oklahoma,0,18984,10754,1184,30922,2016,Feb
2016-02,Oregon,88,17116,11665,0,28781,2016,Feb
2016-02,Pennsylvania,29651,61933,11791,0,73724,2016,Feb
2016-02,Puerto Rico,0,885,152,24,1061,2016,Feb
2016-02,Rhode Island,0,1288,848,64,2200,2016,Feb
2016-02,South Carolina,12817,15746,6847,522,23115,2016,Feb
2016-02,South Dakota,1627,4170,4009,169,8348,2016,Feb
2016-02,Tennessee,12348,36439,18121,0,54560,2016,Feb
2016-02,Texas,56900,72584,37980,3156,113720,2016,Feb
2016-02,Utah,12927,4413,4000,259,8672,2016,Feb
2016-02,Vermont,0,2273,1681,128,4082,2016,Feb
2016-02,Virgin Islands,86,25,4,0,29,2016,Feb
2016-02,Virginia,784,30085,15948,1133,47166,2016,Feb
2016-02,Washington,15736,20583,11991,1832,34406,2016,Feb
2016-02,West Virginia,3527,10746,7436,357,18539,2016,Feb
2016-02,Wisconsin,9420,19465,12431,821,32717,2016,Feb
2016-02,Wyoming,551,2287,2036,139,4462,2016,Feb
2016-01,Alabama,27242,25445,14785,1266,41496,2016,Jan
2016-01,Alaska,192,2859,2245,300,5404,2016,Jan
2016-01,Arizona,3898,15745,8512,1107,25364,2016,Jan
2016-01,Arkansas,3670,7954,5982,305,14241,2016,Jan
2016-01,California,127715,52139,32970,7054,92163,2016,Jan
2016-01,Colorado,8431,23518,13327,1474,38319,2016,Jan
2016-01,Connecticut,14005,13096,4366,236,17698,2016,Jan
2016-01,Delaware,395,2548,1608,110,4266,2016,Jan
2016-01,District of Columbia,27,52,3,0,55,2016,Jan
2016-01,Florida,28458,62085,26356,3480,91921,2016,Jan
2016-01,Georgia,30513,18236,9696,654,28586,2016,Jan
2016-01,Guam,0,102,57,11,170,2016,Jan
2016-01,Hawaii,1379,0,0,0,0,2016,Jan
2016-01,Idaho,4025,4221,3820,266,8307,2016,Jan
2016-01,Illinois,143606,32112,12869,0,44981,2016,Jan
2016-01,Indiana,183520,29653,14356,1871,45880,2016,Jan
2016-01,Iowa,23600,292,2600,44,2936,2016,Jan
2016-01,Kansas,1787,9196,6580,586,16362,2016,Jan
2016-01,Kentucky,277415,13847,7713,403,21963,2016,Jan
2016-01,Louisiana,2823,15485,10374,1054,26913,2016,Jan
2016-01,Maine,500,4625,3054,294,7973,2016,Jan
2016-01,Mariana Islands,0,0,3,0,3,2016,Jan
2016-01,Maryland,3458,3981,5541,116,9638,2016,Jan
2016-01,Massachusetts,8547,7211,3500,667,11378,2016,Jan
2016-01,Michigan,27885,17641,9995,670,28306,2016,Jan
2016-01,Minnesota,27969,12426,8624,875,21925,2016,Jan
2016-01,Mississippi,1442,10257,6713,422,17392,2016,Jan
2016-01,Missouri,11441,28980,15693,1942,46615,2016,Jan
2016-01,Montana,2240,3354,3574,191,7119,2016,Jan
2016-01,Nebraska,8560,179,2256,37,2472,2016,Jan
2016-01,Nevada,2386,6064,2835,289,9188,2016,Jan
2016-01,New Hampshire,5807,7146,3591,211,10948,2016,Jan
2016-01,New Jersey,0,4520,4005,158,8683,2016,Jan
2016-01,New Mexico,769,5921,4206,405,10532,2016,Jan
2016-01,New York,4535,12020,15461,1192,28673,2016,Jan
2016-01,North Carolina,33032,1350,12950,920,15220,2016,Jan
2016-01,North Dakota,800,2159,2554,106,4819,2016,Jan
2016-01,Ohio,13836,38028,18613,2460,59101,2016,Jan
2016-01,Oklahoma,0,18688,10863,1313,30864,2016,Jan
2016-01,Oregon,45,15930,10403,0,26333,2016,Jan
2016-01,Pennsylvania,33905,57355,10224,0,67579,2016,Jan
2016-01,Puerto Rico,0,940,147,16,1103,2016,Jan
2016-01,Rhode Island,0,1413,898,89,2400,2016,Jan
2016-01,South Carolina,10212,12380,6289,669,19338,2016,Jan
2016-01,South Dakota,1872,3782,3815,313,7910,2016,Jan
2016-01,Tennessee,14485,30411,16571,0,46982,2016,Jan
2016-01,Texas,36269,72626,38396,3756,114778,2016,Jan
2016-01,Utah,10485,4662,3654,326,8642,2016,Jan
2016-01,Vermont,0,1863,1379,134,3376,2016,Jan
2016-01,Virgin Islands,73,26,0,0,26,2016,Jan
2016-01,Virginia,524,27033,15699,922,43654,2016,Jan
2016-01,Washington,19688,20427,11355,2147,33929,2016,Jan
2016-01,West Virginia,3378,7419,5505,321,13245,2016,Jan
2016-01,Wisconsin,9496,17969,10756,937,29662,2016,Jan
2016-01,Wyoming,959,2181,1983,160,4324,2016,Jan
2015-12,Alabama,31359,47605,33710,1698,83013,2015,Dec
2015-12,Alaska,245,5265,4638,356,10259,2015,Dec
2015-12,Arizona,2940,25562,14725,1327,41614,2015,Dec
2015-12,Arkansas,4076,13780,15241,365,29386,2015,Dec
2015-12,California,119166,74399,48762,9583,132744,2015,Dec
2015-12,Colorado,3265,34653,22880,1903,59436,2015,Dec
2015-12,Connecticut,12190,17828,6337,314,24479,2015,Dec
2015-12,Delaware,297,3615,3274,175,7064,2015,Dec
2015-12,District of Columbia,16,76,3,0,79,2015,Dec
2015-12,Florida,25044,86940,45769,4165,136874,2015,Dec
2015-12,Georgia,30391,34974,25174,863,61011,2015,Dec
2015-12,Guam,0,145,60,9,214,2015,Dec
2015-12,Hawaii,1642,0,0,0,0,2015,Dec
2015-12,Idaho,2338,7023,7813,320,15156,2015,Dec
2015-12,Illinois,122900,37193,20864,0,58057,2015,Dec
2015-12,Indiana,139460,44150,26105,2370,72625,2015,Dec
2015-12,Iowa,19621,436,5654,51,6141,2015,Dec
2015-12,Kansas,1349,12324,12127,605,25056,2015,Dec
2015-12,Kentucky,258154,25569,19995,607,46171,2015,Dec
2015-12,Louisiana,2023,27778,25151,1302,54231,2015,Dec
2015-12,Maine,360,7493,5410,329,13232,2015,Dec
2015-12,Mariana Islands,0,0,1,0,1,2015,Dec
2015-12,Maryland,2459,4750,10241,112,15103,2015,Dec
2015-12,Massachusetts,7297,9398,4762,864,15024,2015,Dec
2015-12,Michigan,30983,25578,18826,743,45147,2015,Dec
2015-12,Minnesota,30209,16319,15491,1071,32881,2015,Dec
2015-12,Mississippi,1381,20000,18908,540,39448,2015,Dec
2015-12,Missouri,9228,43300,30091,2272,75663,2015,Dec
2015-12,Montana,1865,5902,7250,203,13355,2015,Dec
2015-12,Nebraska,9569,282,4801,36,5119,2015,Dec
2015-12,Nevada,2790,9510,5088,339,14937,2015,Dec
2015-12,New Hampshire,5546,9537,5204,236,14977,2015,Dec
2015-12,New Jersey,0,4304,6531,183,11018,2015,Dec
2015-12,New Mexico,621,9027,7653,553,17233,2015,Dec
2015-12,New York,3366,15179,27786,1300,44265,2015,Dec
2015-12,North Carolina,36332,2536,31238,1282,35056,2015,Dec
2015-12,North Dakota,580,3056,4212,105,7373,2015,Dec
2015-12,Ohio,13879,60280,38256,2942,101478,2015,Dec
2015-12,Oklahoma,0,28388,21086,1550,51024,2015,Dec
2015-12,Oregon,50,23952,17062,0,41014,2015,Dec
2015-12,Pennsylvania,44433,90055,18758,0,108813,2015,Dec
2015-12,Puerto Rico,0,1048,234,31,1313,2015,Dec
2015-12,Rhode Island,0,1663,1316,130,3109,2015,Dec
2015-12,South Carolina,7466,21019,16517,1000,38536,2015,Dec
2015-12,South Dakota,1569,5240,6979,272,12491,2015,Dec
2015-12,Tennessee,10092,51923,36311,0,88234,2015,Dec
2015-12,Texas,33163,107224,80247,4585,192056,2015,Dec
2015-12,Utah,12413,8559,9114,379,18052,2015,Dec
2015-12,Vermont,0,2428,2058,151,4637,2015,Dec
2015-12,Virgin Islands,79,34,2,0,36,2015,Dec
2015-12,Virginia,228,41097,29651,1547,72295,2015,Dec
2015-12,Washington,18190,29473,18515,2380,50368,2015,Dec
2015-12,West Virginia,3377,15080,13869,476,29425,2015,Dec
2015-12,Wisconsin,8126,24898,17831,1134,43863,2015,Dec
2015-12,Wyoming,512,3900,3754,167,7821,2015,Dec
2015-11,Alabama,18870,23022,22650,859,46531,2015,Nov
2015-11,Alaska,209,3062,3209,191,6462,2015,Nov
2015-11,Arizona,2303,12382,9041,707,22130,2015,Nov
2015-11,Arkansas,3298,6359,11611,168,18138,2015,Nov
2015-11,California,98452,41181,35007,4559,80747,2015,Nov
2015-11,Colorado,4144,19784,16082,932,36798,2015,Nov
2015-11,Connecticut,9631,11594,5072,134,16800,2015,Nov
2015-11,Delaware,204,2152,2424,65,4641,2015,Nov
2015-11,District of Columbia,8,54,2,0,56,2015,Nov
2015-11,Florida,15907,50796,28981,2268,82045,2015,Nov
2015-11,Georgia,14111,16635,15227,448,32310,2015,Nov
2015-11,Guam,0,100,55,12,167,2015,Nov
2015-11,Hawaii,1248,0,0,0,0,2015,Nov
2015-11,Idaho,1944,3609,5227,190,9026,2015,Nov
2015-11,Illinois,87190,24412,17227,0,41639,2015,Nov
2015-11,Indiana,81935,25519,20227,1113,46859,2015,Nov
2015-11,Iowa,8785,267,4596,27,4890,2015,Nov
2015-11,Kansas,894,7086,8702,311,16099,2015,Nov
2015-11,Kentucky,264140,12155,14847,254,27256,2015,Nov
2015-11,Louisiana,1945,14708,17368,697,32773,2015,Nov
2015-11,Maine,299,4048,4387,135,8570,2015,Nov
2015-11,Mariana Islands,0,0,0,0,0,2015,Nov
2015-11,Maryland,1512,3220,8310,96,11626,2015,Nov
2015-11,Massachusetts,5214,6083,3931,402,10416,2015,Nov
2015-11,Michigan,16786,13634,17604,385,31623,2015,Nov
2015-11,Minnesota,18939,9373,14173,486,24032,2015,Nov
2015-11,Mississippi,618,9785,13191,267,23243,2015,Nov
2015-11,Missouri,5884,21135,22852,1004,44991,2015,Nov
2015-11,Montana,852,2848,5170,90,8108,2015,Nov
2015-11,Nebraska,4258,173,3724,23,3920,2015,Nov
2015-11,Nevada,1543,4889,3272,193,8354,2015,Nov
2015-11,New Hampshire,3630,4847,4165,95,9107,2015,Nov
2015-11,New Jersey,0,3462,4704,147,8313,2015,Nov
2015-11,New Mexico,829,5247,4974,334,10555,2015,Nov
2015-11,New York,2906,8650,23519,665,32834,2015,Nov
2015-11,North Carolina,22469,1370,20107,576,22053,2015,Nov
2015-11,North Dakota,453,1720,3744,65,5529,2015,Nov
2015-11,Ohio,9338,34878,31817,1392,68087,2015,Nov
2015-11,Oklahoma,0,15005,14753,778,30536,2015,Nov
2015-11,Oregon,35,13586,11832,0,25418,2015,Nov
2015-11,Pennsylvania,24136,62752,16297,0,79049,2015,Nov
2015-11,Puerto Rico,0,1033,170,11,1214,2015,Nov
2015-11,Rhode Island,0,954,932,57,1943,2015,Nov
2015-11,South Carolina,7284,11452,10393,561,22406,2015,Nov
2015-11,South Dakota,819,2765,5484,143,8392,2015,Nov
2015-11,Tennessee,9509,28815,24023,0,52838,2015,Nov
2015-11,Texas,21550,56941,51670,2532,111143,2015,Nov
2015-11,Utah,10429,4314,5857,195,10366,2015,Nov
2015-11,Vermont,0,1189,1826,49,3064,2015,Nov
2015-11,Virgin Islands,93,13,2,0,15,2015,Nov
2015-11,Virginia,622,24052,22348,974,47374,2015,Nov
2015-11,Washington,10314,15822,12425,1238,29485,2015,Nov
2015-11,West Virginia,2217,6953,11561,224,18738,2015,Nov
2015-11,Wisconsin,5867,13700,17759,458,31917,2015,Nov
2015-11,Wyoming,383,1745,2372,87,4204,2015,Nov
2015-10,Alabama,21958,17810,14789,757,33356,2015,Oct
2015-10,Alaska,212,4016,4414,264,8694,2015,Oct
2015-10,Arizona,4502,10928,7308,741,18977,2015,Oct
2015-10,Arkansas,4813,5524,8839,164,14527,2015,Oct
2015-10,California,94134,37977,26151,3912,68040,2015,Oct
2015-10,Colorado,3732,17059,14870,938,32867,2015,Oct
2015-10,Connecticut,10222,9306,4207,183,13696,2015,Oct
2015-10,Delaware,218,1786,1774,93,3653,2015,Oct
2015-10,District of Columbia,4,66,0,0,66,2015,Oct
2015-10,Florida,17963,45304,22587,2456,70347,2015,Oct
2015-10,Georgia,14406,13192,12217,444,25853,2015,Oct
2015-10,Guam,0,119,64,22,205,2015,Oct
2015-10,Hawaii,1378,0,0,0,0,2015,Oct
2015-10,Idaho,1982,2873,5535,176,8584,2015,Oct
2015-10,Illinois,63534,19306,12361,0,31667,2015,Oct
2015-10,Indiana,65285,18633,13859,1055,33547,2015,Oct
2015-10,Iowa,7078,172,3318,26,3516,2015,Oct
2015-10,Kansas,1175,5542,5960,333,11835,2015,Oct
2015-10,Kentucky,250325,9520,10953,260,20733,2015,Oct
2015-10,Louisiana,3099,11765,14348,689,26802,2015,Oct
2015-10,Maine,376,4028,6036,159,10223,2015,Oct
2015-10,Mariana Islands,0,0,1,0,1,2015,Oct
2015-10,Maryland,1914,3389,6110,132,9631,2015,Oct
2015-10,Massachusetts,4960,5226,3146,367,8739,2015,Oct
2015-10,Michigan,16387,10948,13244,341,24533,2015,Oct
2015-10,Minnesota,21361,8661,18163,502,27326,2015,Oct
2015-10,Mississippi,789,7726,8231,279,16236,2015,Oct
2015-10,Missouri,6768,18686,18848,1044,38578,2015,Oct
2015-10,Montana,1077,2701,6840,111,9652,2015,Oct
2015-10,Nebraska,3916,168,2645,17,2830,2015,Oct
2015-10,Nevada,1667,4292,2549,210,7051,2015,Oct
2015-10,New Hampshire,3199,4303,3910,116,8329,2015,Oct
2015-10,New Jersey,0,3668,3507,140,7315,2015,Oct
2015-10,New Mexico,726,5346,4341,314,10001,2015,Oct
2015-10,New York,3803,8329,19836,590,28755,2015,Oct
2015-10,North Carolina,23356,1203,15479,602,17284,2015,Oct
2015-10,North Dakota,577,1634,4868,87,6589,2015,Oct
2015-10,Ohio,9017,27354,20613,1347,49314,2015,Oct
2015-10,Oklahoma,0,11653,10868,743,23264,2015,Oct
2015-10,Oregon,47,13732,11626,0,25358,2015,Oct
2015-10,Pennsylvania,20840,50119,10921,0,61040,2015,Oct
2015-10,Puerto Rico,0,1057,196,12,1265,2015,Oct
2015-10,Rhode Island,0,923,788,52,1763,2015,Oct
2015-10,South Carolina,7517,8301,7176,406,15883,2015,Oct
2015-10,South Dakota,766,2483,6689,259,9431,2015,Oct
2015-10,Tennessee,8033,24423,17480,0,41903,2015,Oct
2015-10,Texas,23495,43428,41157,2836,87421,2015,Oct
2015-10,Utah,11112,2831,3827,158,6816,2015,Oct
2015-10,Vermont,0,1183,1942,58,3183,2015,Oct
2015-10,Virgin Islands,79,19,2,0,21,2015,Oct
2015-10,Virginia,369,20672,17008,908,38588,2015,Oct
2015-10,Washington,11387,14937,12315,1441,28693,2015,Oct
2015-10,West Virginia,2354,6286,8427,237,14950,2015,Oct
2015-10,Wisconsin,5158,12731,16908,603,30242,2015,Oct
2015-10,Wyoming,700,1535,2274,80,3889,2015,Oct
2015-09,Alabama,20999,16038,13392,710,30140,2015,Sep
2015-09,Alaska,184,2294,3037,130,5461,2015,Sep
2015-09,Arizona,4161,10378,7529,677,18584,2015,Sep
2015-09,Arkansas,6286,5356,6595,146,12097,2015,Sep
2015-09,California,64698,31897,24471,3429,59797,2015,Sep
2015-09,Colorado,4151,15186,12898,849,28933,2015,Sep
2015-09,Connecticut,9713,8330,3566,166,12062,2015,Sep
2015-09,Delaware,267,1503,1419,50,2972,2015,Sep
2015-09,District of Columbia,0,40,1,0,41,2015,Sep
2015-09,Florida,16270,40647,20159,2615,63421,2015,Sep
2015-09,Georgia,14837,12323,9659,402,22384,2015,Sep
2015-09,Guam,0,117,48,13,178,2015,Sep
2015-09,Hawaii,1267,0,0,0,0,2015,Sep
2015-09,Idaho,1851,2782,5055,104,7941,2015,Sep
2015-09,Illinois,63566,17451,12693,0,30144,2015,Sep
2015-09,Indiana,53051,16754,11905,965,29624,2015,Sep
2015-09,Iowa,7036,191,2514,23,2728,2015,Sep
2015-09,Kansas,1104,4889,5167,258,10314,2015,Sep
2015-09,Kentucky,241368,8437,8102,214,16753,2015,Sep
2015-09,Louisiana,2620,16564,15861,771,33196,2015,Sep
2015-09,Maine,471,3272,4190,130,7592,2015,Sep
2015-09,Mariana Islands,0,0,1,0,1,2015,Sep
2015-09,Maryland,1140,2615,4779,148,7542,2015,Sep
2015-09,Massachusetts,4632,4543,2442,288,7273,2015,Sep
2015-09,Michigan,27076,9276,11046,315,20637,2015,Sep
2015-09,Minnesota,19575,7639,14880,389,22908,2015,Sep
2015-09,Mississippi,953,9974,8720,263,18957,2015,Sep
2015-09,Missouri,6212,16053,13650,862,30565,2015,Sep
2015-09,Montana,967,2641,5616,118,8375,2015,Sep
2015-09,Nebraska,3157,138,2012,8,2158,2015,Sep
2015-09,Nevada,2204,4183,2499,191,6873,2015,Sep
2015-09,New Hampshire,2963,3802,3112,101,7015,2015,Sep
2015-09,New Jersey,0,3215,2728,113,6056,2015,Sep
2015-09,New Mexico,881,4763,4167,310,9240,2015,Sep
2015-09,New York,3639,7532,15898,544,23974,2015,Sep
2015-09,North Carolina,23350,1131,12571,581,14283,2015,Sep
2015-09,North Dakota,492,1399,3360,61,4820,2015,Sep
2015-09,Ohio,8942,23309,16734,1383,41426,2015,Sep
2015-09,Oklahoma,0,10331,9491,657,20479,2015,Sep
2015-09,Oregon,94,10419,11137,0,21556,2015,Sep
2015-09,Pennsylvania,18607,42205,8762,0,50967,2015,Sep
2015-09,Puerto Rico,0,1036,214,16,1266,2015,Sep
2015-09,Rhode Island,0,816,585,37,1438,2015,Sep
2015-09,South Carolina,6630,8089,6836,410,15335,2015,Sep
2015-09,South Dakota,708,2119,4338,248,6705,2015,Sep
2015-09,Tennessee,15240,21223,14758,0,35981,2015,Sep
2015-09,Texas,20733,39567,45376,2578,87521,2015,Sep
2015-09,Utah,14323,2735,4094,131,6960,2015,Sep
2015-09,Vermont,0,1091,1464,64,2619,2015,Sep
2015-09,Virgin Islands,107,25,1,0,26,2015,Sep
2015-09,Virginia,553,18720,13891,862,33473,2015,Sep
2015-09,Washington,10517,13341,10892,1201,25434,2015,Sep
2015-09,West Virginia,2109,5537,6493,195,12225,2015,Sep
2015-09,Wisconsin,4610,11463,13481,514,25458,2015,Sep
2015-09,Wyoming,484,1498,2275,100,3873,2015,Sep
2015-08,Alabama,25643,17991,13613,703,32307,2015,Aug
2015-08,Alaska,236,2570,3440,142,6152,2015,Aug
2015-08,Arizona,4687,9987,7109,651,17747,2015,Aug
2015-08,Arkansas,6794,5352,5941,155,11448,2015,Aug
2015-08,California,59988,33938,26257,3935,64130,2015,Aug
2015-08,Colorado,5851,15890,12572,776,29238,2015,Aug
2015-08,Connecticut,9522,8418,3398,175,11991,2015,Aug
2015-08,Delaware,338,1570,1392,57,3019,2015,Aug
2015-08,District of Columbia,0,65,2,0,67,2015,Aug
2015-08,Florida,17140,42171,20307,2373,64851,2015,Aug
2015-08,Georgia,14217,12736,9241,393,22370,2015,Aug
2015-08,Guam,0,84,42,15,141,2015,Aug
2015-08,Hawaii,1173,0,0,0,0,2015,Aug
2015-08,Idaho,1708,2723,4163,118,7004,2015,Aug
2015-08,Illinois,64498,18088,11085,0,29173,2015,Aug
2015-08,Indiana,35816,16546,11880,894,29320,2015,Aug
2015-08,Iowa,6064,170,2288,14,2472,2015,Aug
2015-08,Kansas,1222,5378,5354,244,10976,2015,Aug
2015-08,Kentucky,266788,8238,7362,201,15801,2015,Aug
2015-08,Louisiana,1974,13992,11514,650,26156,2015,Aug
2015-08,Maine,491,2966,3249,149,6364,2015,Aug
2015-08,Mariana Islands,0,0,1,0,1,2015,Aug
2015-08,Maryland,1202,2783,4315,101,7199,2015,Aug
2015-08,Massachusetts,4469,5177,2623,329,8129,2015,Aug
2015-08,Michigan,14223,9157,9431,279,18867,2015,Aug
2015-08,Minnesota,18855,7643,11193,370,19206,2015,Aug
2015-08,Mississippi,826,7830,6651,210,14691,2015,Aug
2015-08,Missouri,6121,16501,13231,941,30673,2015,Aug
2015-08,Montana,897,2688,4672,116,7476,2015,Aug
2015-08,Nebraska,3215,140,1955,16,2111,2015,Aug
2015-08,Nevada,1550,3949,2462,178,6589,2015,Aug
2015-08,New Hampshire,3035,3870,3100,77,7047,2015,Aug
2015-08,New Jersey,0,3555,2840,142,6537,2015,Aug
2015-08,New Mexico,736,5029,3835,272,9136,2015,Aug
2015-08,New York,3074,7501,12410,492,20403,2015,Aug
2015-08,North Carolina,21906,1063,11789,575,13427,2015,Aug
2015-08,North Dakota,551,1409,2855,70,4334,2015,Aug
2015-08,Ohio,8706,23147,15795,1132,40074,2015,Aug
2015-08,Oklahoma,0,11425,9936,737,22098,2015,Aug
2015-08,Oregon,15,10589,8789,0,19378,2015,Aug
2015-08,Pennsylvania,19070,41542,7972,0,49514,2015,Aug
2015-08,Puerto Rico,0,1070,227,24,1321,2015,Aug
2015-08,Rhode Island,0,740,575,41,1356,2015,Aug
2015-08,South Carolina,7084,8487,6785,479,15751,2015,Aug
2015-08,South Dakota,684,2233,3728,204,6165,2015,Aug
2015-08,Tennessee,9774,22983,15384,0,38367,2015,Aug
2015-08,Texas,24521,41503,40561,2433,84497,2015,Aug
2015-08,Utah,12489,2689,3477,114,6280,2015,Aug
2015-08,Vermont,0,1171,1190,46,2407,2015,Aug
2015-08,Virgin Islands,79,18,2,0,20,2015,Aug
2015-08,Virginia,364,18252,12733,793,31778,2015,Aug
2015-08,Washington,9054,12705,9373,1070,23148,2015,Aug
2015-08,West Virginia,2266,5565,5742,181,11488,2015,Aug
2015-08,Wisconsin,4398,11549,11531,421,23501,2015,Aug
2015-08,Wyoming,638,1578,2045,80,3703,2015,Aug
2015-07,Alabama,22960,17698,10276,653,28627,2015,Jul
2015-07,Alaska,171,2709,2439,116,5264,2015,Jul
2015-07,Arizona,4262,10226,6078,668,16972,2015,Jul
2015-07,Arkansas,5128,5216,4146,165,9527,2015,Jul
2015-07,California,67429,39980,27844,3995,71819,2015,Jul
2015-07,Colorado,2727,15828,10903,751,27482,2015,Jul
2015-07,Connecticut,10365,8660,3012,158,11830,2015,Jul
2015-07,Delaware,470,1523,1148,58,2729,2015,Jul
2015-07,District of Columbia,0,59,5,0,64,2015,Jul
2015-07,Florida,15769,42570,18069,2133,62772,2015,Jul
2015-07,Georgia,15820,12674,6707,347,19728,2015,Jul
2015-07,Guam,0,119,51,13,183,2015,Jul
2015-07,Hawaii,1155,0,0,0,0,2015,Jul
2015-07,Idaho,1822,2576,3125,121,5822,2015,Jul
2015-07,Illinois,66883,18469,9243,0,27712,2015,Jul
2015-07,Indiana,26099,15416,8954,758,25128,2015,Jul
2015-07,Iowa,6577,120,1563,22,1705,2015,Jul
2015-07,Kansas,1271,5641,3849,227,9717,2015,Jul
2015-07,Kentucky,201788,8223,5645,238,14106,2015,Jul
2015-07,Louisiana,1361,11858,7371,606,19835,2015,Jul
2015-07,Maine,609,2973,2469,117,5559,2015,Jul
2015-07,Mariana Islands,0,0,0,1,1,2015,Jul
2015-07,Maryland,1620,2918,3750,100,6768,2015,Jul
2015-07,Massachusetts,4814,4617,1993,326,6936,2015,Jul
2015-07,Michigan,15819,8837,6681,296,15814,2015,Jul
2015-07,Minnesota,16325,6949,7139,362,14450,2015,Jul
2015-07,Mississippi,1036,7869,4333,240,12442,2015,Jul
2015-07,Missouri,6079,16736,10260,935,27931,2015,Jul
2015-07,Montana,911,2563,3612,92,6267,2015,Jul
2015-07,Nebraska,3055,103,1332,12,1447,2015,Jul
2015-07,Nevada,1723,4074,2201,186,6461,2015,Jul
2015-07,New Hampshire,3059,3675,2517,93,6285,2015,Jul
2015-07,New Jersey,0,3925,2538,125,6588,2015,Jul
2015-07,New Mexico,783,4745,3325,251,8321,2015,Jul
2015-07,New York,2843,8140,9957,416,18513,2015,Jul
2015-07,North Carolina,22174,964,9325,531,10820,2015,Jul
2015-07,North Dakota,804,1400,2040,57,3497,2015,Jul
2015-07,Ohio,8956,23344,13252,1224,37820,2015,Jul
2015-07,Oklahoma,0,11162,7162,690,19014,2015,Jul
2015-07,Oregon,18,9956,8029,0,17985,2015,Jul
2015-07,Pennsylvania,19538,38287,6885,0,45172,2015,Jul
2015-07,Puerto Rico,0,1083,213,12,1308,2015,Jul
2015-07,Rhode Island,0,739,520,78,1337,2015,Jul
2015-07,South Carolina,8984,8486,4989,379,13854,2015,Jul
2015-07,South Dakota,757,1926,2605,132,4663,2015,Jul
2015-07,Tennessee,21886,22803,12231,0,35034,2015,Jul
2015-07,Texas,21479,41237,27981,2300,71518,2015,Jul
2015-07,Utah,10691,2586,2842,179,5607,2015,Jul
2015-07,Vermont,0,1178,939,57,2174,2015,Jul
2015-07,Virgin Islands,126,28,3,0,31,2015,Jul
2015-07,Virginia,624,19564,11481,738,31783,2015,Jul
2015-07,Washington,8993,12222,8220,1000,21442,2015,Jul
2015-07,West Virginia,2262,5632,4503,186,10321,2015,Jul
2015-07,Wisconsin,4367,11408,7673,428,19509,2015,Jul
2015-07,Wyoming,542,1512,1778,65,3355,2015,Jul
2015-06,Alabama,16801,15299,8861,541,24701,2015,Jun
2015-06,Alaska,291,2612,2256,113,4981,2015,Jun
2015-06,Arizona,4728,9616,5804,587,16007,2015,Jun
2015-06,Arkansas,3873,4881,3689,162,8732,2015,Jun
2015-06,California,51944,33287,22795,3763,59845,2015,Jun
2015-06,Colorado,4241,15127,10700,722,26549,2015,Jun
2015-06,Connecticut,11856,9429,3201,119,12749,2015,Jun
2015-06,Delaware,436,1589,1169,59,2817,2015,Jun
2015-06,District of Columbia,0,45,4,0,49,2015,Jun
2015-06,Florida,15397,39592,17115,1989,58696,2015,Jun
2015-06,Georgia,13230,11502,6000,279,17781,2015,Jun
2015-06,Guam,0,108,56,15,179,2015,Jun
2015-06,Hawaii,1209,0,0,0,0,2015,Jun
2015-06,Idaho,2849,2381,3063,126,5570,2015,Jun
2015-06,Illinois,53952,17666,8230,0,25896,2015,Jun
2015-06,Indiana,37734,14845,8455,742,24042,2015,Jun
2015-06,Iowa,5452,184,1634,24,1842,2015,Jun
2015-06,Kansas,1415,4610,3174,222,8006,2015,Jun
2015-06,Kentucky,225599,7280,5300,178,12758,2015,Jun
2015-06,Louisiana,1253,10584,6441,529,17554,2015,Jun
2015-06,Maine,626,2906,2155,127,5188,2015,Jun
2015-06,Mariana Islands,0,0,2,0,2,2015,Jun
2015-06,Maryland,1821,2929,3776,91,6796,2015,Jun
2015-06,Massachusetts,4456,4398,2122,284,6804,2015,Jun
2015-06,Michigan,14561,8683,6668,313,15664,2015,Jun
2015-06,Minnesota,18144,7117,7084,358,14559,2015,Jun
2015-06,Mississippi,729,6160,3422,207,9789,2015,Jun
2015-06,Missouri,6929,16285,9733,949,26967,2015,Jun
2015-06,Montana,904,2514,3684,83,6281,2015,Jun
2015-06,Nebraska,2903,142,1238,14,1394,2015,Jun
2015-06,Nevada,2305,3778,2373,164,6315,2015,Jun
2015-06,New Hampshire,3609,3745,2356,63,6164,2015,Jun
2015-06,New Jersey,0,4261,2606,140,7007,2015,Jun
2015-06,New Mexico,640,4546,3374,307,8227,2015,Jun
2015-06,New York,3222,8140,10400,444,18984,2015,Jun
2015-06,North Carolina,19637,1034,8587,459,10080,2015,Jun
2015-06,North Dakota,808,1335,2008,57,3400,2015,Jun
2015-06,Ohio,9361,22545,13307,1118,36970,2015,Jun
2015-06,Oklahoma,0,10529,6612,679,17820,2015,Jun
2015-06,Oregon,31,9661,8073,0,17734,2015,Jun
2015-06,Pennsylvania,17846,39007,6733,0,45740,2015,Jun
2015-06,Puerto Rico,0,1228,198,26,1452,2015,Jun
2015-06,Rhode Island,0,797,572,31,1400,2015,Jun
2015-06,South Carolina,6565,7693,4135,351,12179,2015,Jun
2015-06,South Dakota,595,1866,2611,126,4603,2015,Jun
2015-06,Tennessee,12888,18596,10241,0,28837,2015,Jun
2015-06,Texas,21211,43199,27650,2432,73281,2015,Jun
2015-06,Utah,14428,2549,2745,152,5446,2015,Jun
2015-06,Vermont,0,1149,890,52,2091,2015,Jun
2015-06,Virgin Islands,75,25,4,0,29,2015,Jun
2015-06,Virginia,504,16539,10126,733,27398,2015,Jun
2015-06,Washington,7915,12207,8243,905,21355,2015,Jun
2015-06,West Virginia,2003,5468,4455,193,10116,2015,Jun
2015-06,Wisconsin,4287,9973,7540,466,17979,2015,Jun
2015-06,Wyoming,764,1380,1731,62,3173,2015,Jun
2015-05,Alabama,15495,15629,9031,525,25185,2015,May
2015-05,Alaska,203,2866,2337,178,5381,2015,May
2015-05,Arizona,4719,10829,6105,590,17524,2015,May
2015-05,Arkansas,4750,4871,3881,170,8922,2015,May
2015-05,California,53467,36049,25174,3848,65071,2015,May
2015-05,Colorado,4338,15660,11252,776,27688,2015,May
2015-05,Connecticut,11817,9170,3432,152,12754,2015,May
2015-05,Delaware,748,1597,1197,38,2832,2015,May
2015-05,District of Columbia,0,50,3,0,53,2015,May
2015-05,Florida,13949,39775,17145,1962,58882,2015,May
2015-05,Georgia,11956,11029,5941,323,17293,2015,May
2015-05,Guam,0,91,44,7,142,2015,May
2015-05,Hawaii,1142,0,0,0,0,2015,May
2015-05,Idaho,2533,2751,3569,131,6451,2015,May
2015-05,Illinois,47092,19457,9346,0,28803,2015,May
2015-05,Indiana,38129,15952,8778,744,25474,2015,May
2015-05,Iowa,5573,167,1781,12,1960,2015,May
2015-05,Kansas,1829,5200,3969,233,9402,2015,May
2015-05,Kentucky,255314,7321,5133,185,12639,2015,May
2015-05,Louisiana,1805,9916,6452,542,16910,2015,May
2015-05,Maine,548,2593,2273,110,4976,2015,May
2015-05,Mariana Islands,0,0,1,0,1,2015,May
2015-05,Maryland,1155,2665,3972,88,6725,2015,May
2015-05,Massachusetts,4692,4529,2296,267,7092,2015,May
2015-05,Michigan,16080,9289,6839,260,16388,2015,May
2015-05,Minnesota,20670,8050,7795,382,16227,2015,May
2015-05,Mississippi,669,6734,3669,159,10562,2015,May
2015-05,Missouri,6510,17111,10085,799,27995,2015,May
2015-05,Montana,892,2840,4108,75,7023,2015,May
2015-05,Nebraska,2841,104,1455,13,1572,2015,May
2015-05,Nevada,2363,4200,2611,170,6981,2015,May
2015-05,New Hampshire,4144,3813,2468,55,6336,2015,May
2015-05,New Jersey,0,4118,2453,133,6704,2015,May
2015-05,New Mexico,732,5143,3645,268,9056,2015,May
2015-05,New York,2788,7767,10516,449,18732,2015,May
2015-05,North Carolina,18448,1155,8393,482,10030,2015,May
2015-05,North Dakota,500,1507,2349,49,3905,2015,May
2015-05,Ohio,10082,22978,12473,1026,36477,2015,May
2015-05,Oklahoma,0,11082,7434,845,19361,2015,May
2015-05,Oregon,33,10537,8722,0,19259,2015,May
2015-05,Pennsylvania,16899,38419,6825,0,45244,2015,May
2015-05,Puerto Rico,0,1263,149,36,1448,2015,May
2015-05,Rhode Island,0,865,520,35,1420,2015,May
2015-05,South Carolina,6173,7725,4088,395,12208,2015,May
2015-05,South Dakota,626,2260,2932,139,5331,2015,May
2015-05,Tennessee,10582,18928,10314,0,29242,2015,May
2015-05,Texas,21646,44935,29899,2679,77513,2015,May
2015-05,Utah,11653,2927,2935,141,6003,2015,May
2015-05,Vermont,0,1152,921,47,2120,2015,May
2015-05,Virgin Islands,101,12,2,0,14,2015,May
2015-05,Virginia,846,17065,9854,680,27599,2015,May
2015-05,Washington,8106,12928,8555,1034,22517,2015,May
2015-05,West Virginia,2272,5596,4499,185,10280,2015,May
2015-05,Wisconsin,4783,10130,8532,483,19145,2015,May
2015-05,Wyoming,493,1758,1871,93,3722,2015,May
2015-04,Alabama,17623,14929,9809,602,25340,2015,Apr
2015-04,Alaska,242,3107,2908,186,6201,2015,Apr
2015-04,Arizona,4046,11236,6438,694,18368,2015,Apr
2015-04,Arkansas,4927,4951,4514,168,9633,2015,Apr
2015-04,California,48166,35479,25542,4370,65391,2015,Apr
2015-04,Colorado,5034,15865,11795,935,28595,2015,Apr
2015-04,Connecticut,13294,9624,3635,122,13381,2015,Apr
2015-04,Delaware,546,1720,1228,64,3012,2015,Apr
2015-04,District of Columbia,0,49,2,0,51,2015,Apr
2015-04,Florida,16049,40786,18180,1996,60962,2015,Apr
2015-04,Georgia,13765,11926,6472,336,18734,2015,Apr
2015-04,Guam,0,84,42,15,141,2015,Apr
2015-04,Hawaii,1327,0,0,0,0,2015,Apr
2015-04,Idaho,3119,2712,3727,140,6579,2015,Apr
2015-04,Illinois,88841,19123,9918,0,29041,2015,Apr
2015-04,Indiana,38811,16372,10732,823,27927,2015,Apr
2015-04,Iowa,8656,211,2163,13,2387,2015,Apr
2015-04,Kansas,2574,5754,4392,242,10388,2015,Apr
2015-04,Kentucky,234945,8012,6829,245,15086,2015,Apr
2015-04,Louisiana,1599,9998,6632,588,17218,2015,Apr
2015-04,Maine,0,3112,2984,142,6238,2015,Apr
2015-04,Mariana Islands,0,0,2,0,2,2015,Apr
2015-04,Maryland,1773,3227,5116,100,8443,2015,Apr
2015-04,Massachusetts,5865,5205,2642,354,8201,2015,Apr
2015-04,Michigan,17298,10428,8134,389,18951,2015,Apr
2015-04,Minnesota,22700,9626,10862,503,20991,2015,Apr
2015-04,Mississippi,876,6771,4061,181,11013,2015,Apr
2015-04,Missouri,7944,17715,12531,812,31058,2015,Apr
2015-04,Montana,1148,2695,4166,97,6958,2015,Apr
2015-04,Nebraska,3521,134,1586,12,1732,2015,Apr
2015-04,Nevada,2604,3891,2533,189,6613,2015,Apr
2015-04,New Hampshire,3373,4277,3015,97,7389,2015,Apr
2015-04,New Jersey,0,4462,3002,130,7594,2015,Apr
2015-04,New Mexico,916,5084,3754,287,9125,2015,Apr
2015-04,New York,3186,9004,13499,557,23060,2015,Apr
2015-04,North Carolina,22434,950,9667,535,11152,2015,Apr
2015-04,North Dakota,677,1530,2666,77,4273,2015,Apr
2015-04,Ohio,12671,26841,16124,1256,44221,2015,Apr
2015-04,Oklahoma,0,12508,8819,841,22168,2015,Apr
2015-04,Oregon,20,11238,9305,0,20543,2015,Apr
2015-04,Pennsylvania,21161,45156,7908,0,53064,2015,Apr
2015-04,Puerto Rico,0,954,170,25,1149,2015,Apr
2015-04,Rhode Island,0,931,594,66,1591,2015,Apr
2015-04,South Carolina,8009,8123,4493,364,12980,2015,Apr
2015-04,South Dakota,720,2474,3118,162,5754,2015,Apr
2015-04,Tennessee,13585,19190,11361,0,30551,2015,Apr
2015-04,Texas,21605,41412,29218,2447,73077,2015,Apr
2015-04,Utah,13427,2720,3124,134,5978,2015,Apr
2015-04,Vermont,0,1470,1477,57,3004,2015,Apr
2015-04,Virgin Islands,90,18,6,0,24,2015,Apr
2015-04,Virginia,658,18272,12038,686,30996,2015,Apr
2015-04,Washington,9867,14397,9063,1206,24666,2015,Apr
2015-04,West Virginia,3212,6777,5845,206,12828,2015,Apr
2015-04,Wisconsin,6576,11606,12006,564,24176,2015,Apr
2015-04,Wyoming,559,1668,1995,70,3733,2015,Apr
2015-03,Alabama,21726,17870,12707,701,31278,2015,Mar
2015-03,Alaska,255,3114,3092,206,6412,2015,Mar
2015-03,Arizona,4107,12720,7999,777,21496,2015,Mar
2015-03,Arkansas,4650,7010,5843,198,13051,2015,Mar
2015-03,California,126134,38597,30120,3822,72539,2015,Mar
2015-03,Colorado,3710,17716,14259,939,32914,2015,Mar
2015-03,Connecticut,13911,11432,4709,250,16391,2015,Mar
2015-03,Delaware,500,2145,1741,77,3963,2015,Mar
2015-03,District of Columbia,0,62,4,0,66,2015,Mar
2015-03,Florida,17066,46739,22690,2279,71708,2015,Mar
2015-03,Georgia,18105,16366,9436,459,26261,2015,Mar
2015-03,Guam,0,96,47,13,156,2015,Mar
2015-03,Hawaii,1344,0,0,0,0,2015,Mar
2015-03,Idaho,3323,3303,4416,179,7898,2015,Mar
2015-03,Illinois,68243,17517,10329,0,27846,2015,Mar
2015-03,Indiana,44831,22176,13898,1201,37275,2015,Mar
2015-03,Iowa,11320,295,3211,24,3530,2015,Mar
2015-03,Kansas,2514,6823,5529,296,12648,2015,Mar
2015-03,Kentucky,258825,10407,8327,283,19017,2015,Mar
2015-03,Louisiana,1589,12506,9438,797,22741,2015,Mar
2015-03,Maine,0,3634,3215,207,7056,2015,Mar
2015-03,Mariana Islands,0,0,2,0,2,2015,Mar
2015-03,Maryland,1800,3235,5268,134,8637,2015,Mar
2015-03,Massachusetts,5379,6905,3446,380,10731,2015,Mar
2015-03,Michigan,17994,13506,10617,431,24554,2015,Mar
2015-03,Minnesota,27319,10796,12244,575,23615,2015,Mar
2015-03,Mississippi,1167,8788,5791,276,14855,2015,Mar
2015-03,Missouri,9321,23164,15636,1086,39886,2015,Mar
2015-03,Montana,1266,3203,4804,125,8132,2015,Mar
2015-03,Nebraska,4531,123,2037,16,2176,2015,Mar
2015-03,Nevada,2226,4938,3075,242,8255,2015,Mar
2015-03,New Hampshire,3529,4853,3215,105,8173,2015,Mar
2015-03,New Jersey,0,4924,3456,149,8529,2015,Mar
2015-03,New Mexico,834,6149,4853,357,11359,2015,Mar
2015-03,New York,4253,9776,14574,663,25013,2015,Mar
2015-03,North Carolina,27047,1182,12154,639,13975,2015,Mar
2015-03,North Dakota,751,2086,3302,92,5480,2015,Mar
2015-03,Ohio,4378,32293,20400,1797,54490,2015,Mar
2015-03,Oklahoma,0,14307,10437,981,25725,2015,Mar
2015-03,Oregon,97,12693,11105,0,23798,2015,Mar
2015-03,Pennsylvania,24290,56770,10644,0,67414,2015,Mar
2015-03,Puerto Rico,0,1131,163,59,1353,2015,Mar
2015-03,Rhode Island,0,1038,743,54,1835,2015,Mar
2015-03,South Carolina,7695,9999,6364,446,16809,2015,Mar
2015-03,South Dakota,1115,3103,4041,169,7313,2015,Mar
2015-03,Tennessee,1967,22617,14513,0,37130,2015,Mar
2015-03,Texas,23183,53371,36853,2987,93211,2015,Mar
2015-03,Utah,15127,3186,3867,159,7212,2015,Mar
2015-03,Vermont,0,1522,1485,51,3058,2015,Mar
2015-03,Virgin Islands,84,9,3,0,12,2015,Mar
2015-03,Virginia,389,22865,15230,923,39018,2015,Mar
2015-03,Washington,11525,15965,11213,1310,28488,2015,Mar
2015-03,West Virginia,6320,9314,6894,307,16515,2015,Mar
2015-03,Wisconsin,7023,14792,14421,680,29893,2015,Mar
2015-03,Wyoming,659,2023,2247,96,4366,2015,Mar
2015-02,Alabama,16692,23552,14293,844,38689,2015,Feb
2015-02,Alaska,238,3032,2552,211,5795,2015,Feb
2015-02,Arizona,3728,13951,8211,754,22916,2015,Feb
2015-02,Arkansas,3025,8799,7037,201,16037,2015,Feb
2015-02,California,42920,37478,27480,4417,69375,2015,Feb
2015-02,Colorado,4142,18284,12985,936,32205,2015,Feb
2015-02,Connecticut,10345,9806,3890,246,13942,2015,Feb
2015-02,Delaware,104,2135,1681,79,3895,2015,Feb
2015-02,District of Columbia,0,53,0,0,53,2015,Feb
2015-02,Florida,16779,52791,24827,2303,79921,2015,Feb
2015-02,Georgia,16436,22438,11166,493,34097,2015,Feb
2015-02,Guam,0,86,47,11,144,2015,Feb
2015-02,Hawaii,1193,0,0,0,0,2015,Feb
2015-02,Idaho,2841,3723,4415,206,8344,2015,Feb
2015-02,Illinois,48310,23614,13379,0,36993,2015,Feb
2015-02,Indiana,43228,24373,13650,1152,39175,2015,Feb
2015-02,Iowa,13054,268,2984,35,3287,2015,Feb
2015-02,Kansas,2233,7694,6109,320,14123,2015,Feb
2015-02,Kentucky,167767,13909,9486,310,23705,2015,Feb
2015-02,Louisiana,6327,13427,9717,631,23775,2015,Feb
2015-02,Maine,0,2962,2545,169,5676,2015,Feb
2015-02,Mariana Islands,0,0,3,2,5,2015,Feb
2015-02,Maryland,1103,2815,4670,144,7629,2015,Feb
2015-02,Massachusetts,3811,4621,2174,295,7090,2015,Feb
2015-02,Michigan,14368,13093,9906,414,23413,2015,Feb
2015-02,Minnesota,19155,9846,9858,645,20349,2015,Feb
2015-02,Mississippi,771,11559,6964,258,18781,2015,Feb
2015-02,Missouri,7327,26048,15858,1120,43026,2015,Feb
2015-02,Montana,1109,3178,4248,131,7557,2015,Feb
2015-02,Nebraska,4269,133,2156,25,2314,2015,Feb
2015-02,Nevada,2021,5338,3100,229,8667,2015,Feb
2015-02,New Hampshire,2190,4184,2529,109,6822,2015,Feb
2015-02,New Jersey,0,4101,3005,123,7229,2015,Feb
2015-02,New Mexico,748,6039,4625,342,11006,2015,Feb
2015-02,New York,2886,8512,13343,643,22498,2015,Feb
2015-02,North Carolina,24718,1364,14638,772,16774,2015,Feb
2015-02,North Dakota,433,1862,2783,106,4751,2015,Feb
2015-02,Ohio,2,34137,18836,1682,54655,2015,Feb
2015-02,Oklahoma,0,16251,10864,932,28047,2015,Feb
2015-02,Oregon,51,13230,10932,0,24162,2015,Feb
2015-02,Pennsylvania,20284,51886,8727,0,60613,2015,Feb
2015-02,Puerto Rico,0,1054,187,11,1252,2015,Feb
2015-02,Rhode Island,0,922,635,59,1616,2015,Feb
2015-02,South Carolina,6678,13831,7072,500,21403,2015,Feb
2015-02,South Dakota,569,3449,4167,173,7789,2015,Feb
2015-02,Tennessee,8703,27069,16763,0,43832,2015,Feb
2015-02,Texas,17042,60204,39798,3091,103093,2015,Feb
2015-02,Utah,11420,3668,4018,211,7897,2015,Feb
2015-02,Vermont,0,1649,1421,83,3153,2015,Feb
2015-02,Virgin Islands,102,8,2,0,10,2015,Feb
2015-02,Virginia,492,23999,15237,1040,40276,2015,Feb
2015-02,Washington,10199,15771,11434,1431,28636,2015,Feb
2015-02,West Virginia,1692,9538,7719,262,17519,2015,Feb
2015-02,Wisconsin,5432,13332,12361,746,26439,2015,Feb
2015-02,Wyoming,546,2131,2092,117,4340,2015,Feb
2015-01,Alabama,16077,16291,12944,849,30084,2015,Jan
2015-01,Alaska,196,2439,2050,225,4714,2015,Jan
2015-01,Arizona,3690,10585,6808,723,18116,2015,Jan
2015-01,Arkansas,3896,5295,5760,202,11257,2015,Jan
2015-01,California,47134,37560,23524,4060,65144,2015,Jan
2015-01,Colorado,3404,15739,11932,1031,28702,2015,Jan
2015-01,Connecticut,10699,9910,3891,211,14012,2015,Jan
2015-01,Delaware,392,1910,1596,82,3588,2015,Jan
2015-01,District of Columbia,0,55,6,0,61,2015,Jan
2015-01,Florida,13798,43909,21939,2433,68281,2015,Jan
2015-01,Georgia,15535,13650,9280,404,23334,2015,Jan
2015-01,Guam,0,101,49,13,163,2015,Jan
2015-01,Hawaii,1188,0,0,0,0,2015,Jan
2015-01,Idaho,2719,2568,3342,187,6097,2015,Jan
2015-01,Illinois,63009,20682,12203,0,32885,2015,Jan
2015-01,Indiana,34934,18433,11935,1081,31449,2015,Jan
2015-01,Iowa,9736,197,2486,44,2727,2015,Jan
2015-01,Kansas,2300,5724,5577,331,11632,2015,Jan
2015-01,Kentucky,298959,9629,7663,241,17533,2015,Jan
2015-01,Louisiana,43,10760,10358,789,21907,2015,Jan
2015-01,Maine,0,2617,2285,168,5070,2015,Jan
2015-01,Mariana Islands,0,0,0,1,1,2015,Jan
2015-01,Maryland,1623,2542,4795,108,7445,2015,Jan
2015-01,Massachusetts,4937,5139,2568,337,8044,2015,Jan
2015-01,Michigan,15459,9260,7923,436,17619,2015,Jan
2015-01,Minnesota,20089,8181,7949,604,16734,2015,Jan
2015-01,Mississippi,837,6798,6220,261,13279,2015,Jan
2015-01,Missouri,7340,21243,13943,1185,36371,2015,Jan
2015-01,Montana,943,2204,3380,114,5698,2015,Jan
2015-01,Nebraska,3915,169,2057,21,2247,2015,Jan
2015-01,Nevada,2061,3936,2553,219,6708,2015,Jan
2015-01,New Hampshire,2940,4097,2652,118,6867,2015,Jan
2015-01,New Jersey,0,3854,3163,127,7144,2015,Jan
2015-01,New Mexico,471,4548,3689,353,8590,2015,Jan
2015-01,New York,3923,9002,12478,597,22077,2015,Jan
2015-01,North Carolina,23597,1291,13043,641,14975,2015,Jan
2015-01,North Dakota,689,1672,2793,81,4546,2015,Jan
2015-01,Ohio,0,26268,16186,1678,44132,2015,Jan
2015-01,Oklahoma,0,13234,9811,1006,24051,2015,Jan
2015-01,Oregon,62,10601,8766,0,19367,2015,Jan
2015-01,Pennsylvania,20519,44966,7800,0,52766,2015,Jan
2015-01,Puerto Rico,0,1031,148,11,1190,2015,Jan
2015-01,Rhode Island,0,886,622,63,1571,2015,Jan
2015-01,South Carolina,6266,8767,6156,507,15430,2015,Jan
2015-01,South Dakota,0,2399,3631,188,6218,2015,Jan
2015-01,Tennessee,19362,22197,15007,0,37204,2015,Jan
2015-01,Texas,18530,44153,36397,2852,83402,2015,Jan
2015-01,Utah,12100,2923,3317,198,6438,2015,Jan
2015-01,Vermont,0,1171,1081,72,2324,2015,Jan
2015-01,Virgin Islands,67,7,4,1,12,2015,Jan
2015-01,Virginia,379,21023,14433,844,36300,2015,Jan
2015-01,Washington,10516,13781,9419,1423,24623,2015,Jan
2015-01,West Virginia,1450,6881,5876,289,13046,2015,Jan
2015-01,Wisconsin,4614,9703,9221,608,19532,2015,Jan
2015-01,Wyoming,394,1646,1830,106,3582,2015,Jan
2014-12,Alabama,16469,23630,29449,773,53852,2014,Dec
2014-12,Alaska,212,4259,4189,305,8753,2014,Dec
2014-12,Arizona,3892,14200,11509,842,26551,2014,Dec
2014-12,Arkansas,3675,8260,14121,191,22572,2014,Dec
2014-12,California,41907,66770,47409,6956,121135,2014,Dec
2014-12,Colorado,4623,20924,19494,1067,41485,2014,Dec
2014-12,Connecticut,10560,11516,5542,257,17315,2014,Dec
2014-12,Delaware,226,2320,3079,89,5488,2014,Dec
2014-12,District of Columbia,0,50,3,0,53,2014,Dec
2014-12,Florida,12339,50412,37098,2500,90010,2014,Dec
2014-12,Georgia,12759,19541,22872,539,42952,2014,Dec
2014-12,Guam,0,117,58,21,196,2014,Dec
2014-12,Hawaii,1389,0,0,0,0,2014,Dec
2014-12,Idaho,2545,4260,6913,227,11400,2014,Dec
2014-12,Illinois,101641,24857,19709,0,44566,2014,Dec
2014-12,Indiana,27509,23399,21186,1044,45629,2014,Dec
2014-12,Iowa,8371,260,5574,39,5873,2014,Dec
2014-12,Kansas,2328,7333,10739,363,18435,2014,Dec
2014-12,Kentucky,259142,14308,17629,308,32245,2014,Dec
2014-12,Louisiana,26,15337,25507,740,41584,2014,Dec
2014-12,Maine,0,3653,4701,223,8577,2014,Dec
2014-12,Mariana Islands,0,0,0,0,0,2014,Dec
2014-12,Maryland,933,2839,8357,115,11311,2014,Dec
2014-12,Massachusetts,5009,5486,3263,383,9132,2014,Dec
2014-12,Michigan,13920,11860,15576,433,27869,2014,Dec
2014-12,Minnesota,19221,9357,13082,577,23016,2014,Dec
2014-12,Mississippi,607,10726,17253,268,28247,2014,Dec
2014-12,Missouri,6542,27713,25507,1224,54444,2014,Dec
2014-12,Montana,850,3913,6802,109,10824,2014,Dec
2014-12,Nebraska,4142,184,4455,29,4668,2014,Dec
2014-12,Nevada,2029,5202,4356,285,9843,2014,Dec
2014-12,New Hampshire,2938,5059,4122,100,9281,2014,Dec
2014-12,New Jersey,0,3796,4768,148,8712,2014,Dec
2014-12,New Mexico,825,6575,6721,383,13679,2014,Dec
2014-12,New York,2978,9349,21403,604,31356,2014,Dec
2014-12,North Carolina,22263,1745,27082,658,29485,2014,Dec
2014-12,North Dakota,408,2020,4018,74,6112,2014,Dec
2014-12,Ohio,0,35658,30752,1609,68019,2014,Dec
2014-12,Oklahoma,0,19055,20488,1054,40597,2014,Dec
2014-12,Oregon,67,14346,13994,0,28340,2014,Dec
2014-12,Pennsylvania,20786,61828,12737,0,74565,2014,Dec
2014-12,Puerto Rico,0,1158,205,12,1375,2014,Dec
2014-12,Rhode Island,0,895,894,59,1848,2014,Dec
2014-12,South Carolina,5846,11905,14320,477,26702,2014,Dec
2014-12,South Dakota,1,3098,5897,160,9155,2014,Dec
2014-12,Tennessee,11115,30117,30298,0,60415,2014,Dec
2014-12,Texas,18336,66280,78321,3420,148021,2014,Dec
2014-12,Utah,12359,4744,8018,206,12968,2014,Dec
2014-12,Vermont,0,1306,1715,70,3091,2014,Dec
2014-12,Virgin Islands,81,13,0,0,13,2014,Dec
2014-12,Virginia,212,24410,24225,1092,49727,2014,Dec
2014-12,Washington,10625,19476,15253,1647,36376,2014,Dec
2014-12,West Virginia,1069,9844,12767,338,22949,2014,Dec
2014-12,Wisconsin,3724,12139,14806,574,27519,2014,Dec
2014-12,Wyoming,363,2729,3383,111,6223,2014,Dec
2014-11,Alabama,11509,16301,22502,544,39347,2014,Nov
2014-11,Alaska,250,3047,3798,257,7102,2014,Nov
2014-11,Arizona,3705,9974,9362,643,19979,2014,Nov
2014-11,Arkansas,3982,5277,12356,166,17799,2014,Nov
2014-11,California,48671,43779,34964,4087,82830,2014,Nov
2014-11,Colorado,2807,15478,16152,847,32477,2014,Nov
2014-11,Connecticut,9193,9106,4957,167,14230,2014,Nov
2014-11,Delaware,97,1846,2649,78,4573,2014,Nov
2014-11,District of Columbia,0,43,2,0,45,2014,Nov
2014-11,Florida,10477,39126,30723,1974,71823,2014,Nov
2014-11,Georgia,9808,12951,16489,418,29858,2014,Nov
2014-11,Guam,0,89,47,17,153,2014,Nov
2014-11,Hawaii,1078,0,0,0,0,2014,Nov
2014-11,Idaho,2126,2611,5013,168,7792,2014,Nov
2014-11,Illinois,66164,19282,18280,0,37562,2014,Nov
2014-11,Indiana,96876,16681,20381,824,37886,2014,Nov
2014-11,Iowa,5596,174,5018,19,5211,2014,Nov
2014-11,Kansas,1607,5428,9622,227,15277,2014,Nov
2014-11,Kentucky,54751,8807,15632,228,24667,2014,Nov
2014-11,Louisiana,4,10660,19375,548,30583,2014,Nov
2014-11,Maine,0,2356,4426,137,6919,2014,Nov
2014-11,Mariana Islands,0,0,1,0,1,2014,Nov
2014-11,Maryland,886,2290,8896,84,11270,2014,Nov
2014-11,Massachusetts,4647,4698,3370,360,8428,2014,Nov
2014-11,Michigan,12590,8752,17256,281,26289,2014,Nov
2014-11,Minnesota,16885,6462,13470,405,20337,2014,Nov
2014-11,Mississippi,706,6019,13482,207,19708,2014,Nov
2014-11,Missouri,5189,23419,26565,841,50825,2014,Nov
2014-11,Montana,663,2442,5296,92,7830,2014,Nov
2014-11,Nebraska,3041,135,3757,20,3912,2014,Nov
2014-11,Nevada,951,3807,3308,230,7345,2014,Nov
2014-11,New Hampshire,2484,3838,3784,72,7694,2014,Nov
2014-11,New Jersey,0,3141,4357,114,7612,2014,Nov
2014-11,New Mexico,623,4734,5370,261,10365,2014,Nov
2014-11,New York,3233,6959,22126,489,29574,2014,Nov
2014-11,North Carolina,16716,1210,22312,483,24005,2014,Nov
2014-11,North Dakota,361,1447,4023,69,5539,2014,Nov
2014-11,Ohio,0,26893,32001,1413,60307,2014,Nov
2014-11,Oklahoma,0,14060,17558,911,32529,2014,Nov
2014-11,Oregon,52,10465,11486,0,21951,2014,Nov
2014-11,Pennsylvania,16515,57010,13907,22,70939,2014,Nov
2014-11,Puerto Rico,0,1146,171,14,1331,2014,Nov
2014-11,Rhode Island,0,836,796,48,1680,2014,Nov
2014-11,South Carolina,4590,8668,10869,412,19949,2014,Nov
2014-11,South Dakota,2,2231,5750,115,8096,2014,Nov
2014-11,Tennessee,8312,21010,24913,0,45923,2014,Nov
2014-11,Texas,15978,47340,58551,2544,108435,2014,Nov
2014-11,Utah,9212,3189,5890,146,9225,2014,Nov
2014-11,Vermont,0,932,1814,47,2793,2014,Nov
2014-11,Virgin Islands,80,12,2,0,14,2014,Nov
2014-11,Virginia,208,19685,23164,898,43747,2014,Nov
2014-11,Washington,9260,16080,13996,1886,31962,2014,Nov
2014-11,West Virginia,780,6057,12780,181,19018,2014,Nov
2014-11,Wisconsin,4299,8645,16950,434,26029,2014,Nov
2014-11,Wyoming,511,1675,2637,85,4397,2014,Nov
2014-10,Alabama,15305,13930,14643,507,29080,2014,Oct
2014-10,Alaska,218,3997,4406,246,8649,2014,Oct
2014-10,Arizona,4094,9557,7966,577,18100,2014,Oct
2014-10,Arkansas,4214,5164,9255,138,14557,2014,Oct
2014-10,California,50300,42829,30607,3536,76972,2014,Oct
2014-10,Colorado,4362,14704,14649,746,30099,2014,Oct
2014-10,Connecticut,10783,8934,4654,119,13707,2014,Oct
2014-10,Delaware,128,1562,1941,65,3568,2014,Oct
2014-10,District of Columbia,0,50,1,0,51,2014,Oct
2014-10,Florida,14077,38428,23668,1904,64000,2014,Oct
2014-10,Georgia,13571,11239,12696,337,24272,2014,Oct
2014-10,Guam,0,112,40,14,166,2014,Oct
2014-10,Hawaii,1330,0,0,0,0,2014,Oct
2014-10,Idaho,2888,2351,5239,125,7715,2014,Oct
2014-10,Illinois,70325,17927,14023,0,31950,2014,Oct
2014-10,Indiana,47593,16054,15005,733,31792,2014,Oct
2014-10,Iowa,6822,176,3667,22,3865,2014,Oct
2014-10,Kansas,2200,4725,6092,248,11065,2014,Oct
2014-10,Kentucky,6049,8530,11463,211,20204,2014,Oct
2014-10,Louisiana,0,9658,15343,519,25520,2014,Oct
2014-10,Maine,0,2800,6552,117,9469,2014,Oct
2014-10,Mariana Islands,0,0,2,0,2,2014,Oct
2014-10,Maryland,1285,2410,5964,104,8478,2014,Oct
2014-10,Massachusetts,5639,4902,3343,272,8517,2014,Oct
2014-10,Michigan,16955,8642,13602,279,22523,2014,Oct
2014-10,Minnesota,18322,7461,17386,407,25254,2014,Oct
2014-10,Mississippi,760,6024,8325,176,14525,2014,Oct
2014-10,Missouri,6337,18128,20255,834,39217,2014,Oct
2014-10,Montana,1112,2651,6683,88,9422,2014,Oct
2014-10,Nebraska,3741,130,2698,13,2841,2014,Oct
2014-10,Nevada,1211,3830,2880,195,6905,2014,Oct
2014-10,New Hampshire,3392,3975,4109,90,8174,2014,Oct
2014-10,New Jersey,0,3583,3736,116,7435,2014,Oct
2014-10,New Mexico,971,4910,4780,246,9936,2014,Oct
2014-10,New York,3703,8190,21900,392,30482,2014,Oct
2014-10,North Carolina,20331,1155,15491,465,17111,2014,Oct
2014-10,North Dakota,463,1598,5306,62,6966,2014,Oct
2014-10,Ohio,0,25552,22111,1495,49158,2014,Oct
2014-10,Oklahoma,0,12353,12430,717,25500,2014,Oct
2014-10,Oregon,25,9939,10701,0,20640,2014,Oct
2014-10,Pennsylvania,22166,50150,10758,0,60908,2014,Oct
2014-10,Puerto Rico,0,1151,195,8,1354,2014,Oct
2014-10,Rhode Island,0,907,806,55,1768,2014,Oct
2014-10,South Carolina,6472,7251,7633,271,15155,2014,Oct
2014-10,South Dakota,8,2172,6508,122,8802,2014,Oct
2014-10,Tennessee,7403,19184,17453,0,36637,2014,Oct
2014-10,Texas,19667,39725,44864,2317,86906,2014,Oct
2014-10,Utah,9097,2335,4064,83,6482,2014,Oct
2014-10,Vermont,0,1130,1853,57,3040,2014,Oct
2014-10,Virgin Islands,99,27,1,0,28,2014,Oct
2014-10,Virginia,203,18009,17273,934,36216,2014,Oct
2014-10,Washington,10635,13942,12017,1205,27164,2014,Oct
2014-10,West Virginia,1024,6080,9459,178,15717,2014,Oct
2014-10,Wisconsin,5280,10459,16475,456,27390,2014,Oct
2014-10,Wyoming,541,1597,2630,56,4283,2014,Oct
2014-09,Alabama,14261,12337,13130,456,25923,2014,Sep
2014-09,Alaska,217,2416,3273,120,5809,2014,Sep
2014-09,Arizona,4108,8689,7451,606,16746,2014,Sep
2014-09,Arkansas,2787,4074,6480,115,10669,2014,Sep
2014-09,California,48291,37720,28503,3278,69501,2014,Sep
2014-09,Colorado,3266,13033,12658,639,26330,2014,Sep
2014-09,Connecticut,10512,7785,3660,144,11589,2014,Sep
2014-09,Delaware,94,1370,1688,45,3103,2014,Sep
2014-09,District of Columbia,0,47,1,0,48,2014,Sep
2014-09,Florida,11525,37253,21661,1791,60705,2014,Sep
2014-09,Georgia,11240,9973,9497,294,19764,2014,Sep
2014-09,Guam,0,86,44,47,177,2014,Sep
2014-09,Hawaii,1153,0,0,0,0,2014,Sep
2014-09,Idaho,2454,2367,4956,69,7392,2014,Sep
2014-09,Illinois,88071,16060,12191,0,28251,2014,Sep
2014-09,Indiana,6439,13876,12326,647,26849,2014,Sep
2014-09,Iowa,5545,178,2660,23,2861,2014,Sep
2014-09,Kansas,1939,3935,5343,187,9465,2014,Sep
2014-09,Kentucky,60765,6912,8077,183,15172,2014,Sep
2014-09,Louisiana,0,11352,16638,518,28508,2014,Sep
2014-09,Maine,0,2440,4596,120,7156,2014,Sep
2014-09,Mariana Islands,0,0,2,0,2,2014,Sep
2014-09,Maryland,1045,2282,4797,87,7166,2014,Sep
2014-09,Massachusetts,5455,4098,2420,254,6772,2014,Sep
2014-09,Michigan,16646,7668,12051,242,19961,2014,Sep
2014-09,Minnesota,17953,6621,15768,375,22764,2014,Sep
2014-09,Mississippi,818,7427,8847,190,16464,2014,Sep
2014-09,Missouri,5133,14837,14838,646,30321,2014,Sep
2014-09,Montana,881,2562,5273,76,7911,2014,Sep
2014-09,Nebraska,3191,90,2156,13,2259,2014,Sep
2014-09,Nevada,1475,3517,2803,153,6473,2014,Sep
2014-09,New Hampshire,2897,3466,3192,67,6725,2014,Sep
2014-09,New Jersey,0,3492,2854,124,6470,2014,Sep
2014-09,New Mexico,1030,4080,4168,203,8451,2014,Sep
2014-09,New York,3488,7350,16835,455,24640,2014,Sep
2014-09,North Carolina,17095,926,12314,364,13604,2014,Sep
2014-09,North Dakota,298,1389,3798,49,5236,2014,Sep
2014-09,Ohio,0,20852,17783,912,39547,2014,Sep
2014-09,Oklahoma,0,10040,10567,573,21180,2014,Sep
2014-09,Oregon,66,9089,10389,0,19478,2014,Sep
2014-09,Pennsylvania,20044,42506,8823,0,51329,2014,Sep
2014-09,Puerto Rico,0,1018,224,11,1253,2014,Sep
2014-09,Rhode Island,0,779,627,49,1455,2014,Sep
2014-09,South Carolina,5486,6192,6127,253,12572,2014,Sep
2014-09,South Dakota,1,2006,4479,109,6594,2014,Sep
2014-09,Tennessee,6139,16841,14442,0,31283,2014,Sep
2014-09,Texas,16930,34837,46899,1949,83685,2014,Sep
2014-09,Utah,9956,2458,4059,90,6607,2014,Sep
2014-09,Vermont,0,1033,1604,45,2682,2014,Sep
2014-09,Virgin Islands,100,8,4,0,12,2014,Sep
2014-09,Virginia,109,16028,14835,754,31617,2014,Sep
2014-09,Washington,8868,11366,10589,919,22874,2014,Sep
2014-09,West Virginia,824,5203,7365,189,12757,2014,Sep
2014-09,Wisconsin,3991,9224,13579,412,23215,2014,Sep
2014-09,Wyoming,627,1514,2483,53,4050,2014,Sep
2014-08,Alabama,14823,13082,11806,504,25392,2014,Aug
2014-08,Alaska,190,2923,3852,143,6918,2014,Aug
2014-08,Arizona,6743,9189,7159,616,16964,2014,Aug
2014-08,Arkansas,3028,4075,5296,102,9473,2014,Aug
2014-08,California,45625,38710,30590,3454,72754,2014,Aug
2014-08,Colorado,4055,14088,12531,639,27258,2014,Aug
2014-08,Connecticut,7758,6001,2553,77,8631,2014,Aug
2014-08,Delaware,238,1427,1623,53,3103,2014,Aug
2014-08,District of Columbia,0,44,3,0,47,2014,Aug
2014-08,Florida,11081,37260,19794,2009,59063,2014,Aug
2014-08,Georgia,11493,10608,8358,291,19257,2014,Aug
2014-08,Guam,0,82,47,29,158,2014,Aug
2014-08,Hawaii,1130,0,0,0,0,2014,Aug
2014-08,Idaho,2709,2298,3968,97,6363,2014,Aug
2014-08,Illinois,62282,16532,12191,0,28723,2014,Aug
2014-08,Indiana,7583,15459,12168,662,28289,2014,Aug
2014-08,Iowa,5476,117,2205,18,2340,2014,Aug
2014-08,Kansas,1418,3930,4968,201,9099,2014,Aug
2014-08,Kentucky,213126,7230,7382,155,14767,2014,Aug
2014-08,Louisiana,0,10024,10791,575,21390,2014,Aug
2014-08,Maine,0,2299,3387,113,5799,2014,Aug
2014-08,Mariana Islands,0,0,0,0,0,2014,Aug
2014-08,Maryland,960,2393,4587,62,7042,2014,Aug
2014-08,Massachusetts,5807,4868,2726,320,7914,2014,Aug
2014-08,Michigan,13597,7886,9867,267,18020,2014,Aug
2014-08,Minnesota,17989,6595,11540,378,18513,2014,Aug
2014-08,Mississippi,634,5690,6078,176,11944,2014,Aug
2014-08,Missouri,4586,17329,14418,677,32424,2014,Aug
2014-08,Montana,835,2712,4427,68,7207,2014,Aug
2014-08,Nebraska,2681,81,1878,8,1967,2014,Aug
2014-08,Nevada,1400,3749,2720,189,6658,2014,Aug
2014-08,New Hampshire,2811,3616,3162,74,6852,2014,Aug
2014-08,New Jersey,0,3653,3035,140,6828,2014,Aug
2014-08,New Mexico,745,4498,3949,205,8652,2014,Aug
2014-08,New York,5904,7025,13388,415,20828,2014,Aug
2014-08,North Carolina,16602,930,12038,448,13416,2014,Aug
2014-08,North Dakota,549,1353,2979,49,4381,2014,Aug
2014-08,Ohio,0,20742,16787,939,38468,2014,Aug
2014-08,Oklahoma,0,10714,9635,600,20949,2014,Aug
2014-08,Oregon,31,8476,8157,0,16633,2014,Aug
2014-08,Pennsylvania,18353,40384,8958,0,49342,2014,Aug
2014-08,Puerto Rico,0,1078,256,8,1342,2014,Aug
2014-08,Rhode Island,0,790,683,37,1510,2014,Aug
2014-08,South Carolina,6875,6621,5989,329,12939,2014,Aug
2014-08,South Dakota,0,1972,3693,72,5737,2014,Aug
2014-08,Tennessee,7569,17136,14233,0,31369,2014,Aug
2014-08,Texas,16910,38172,43507,2309,83988,2014,Aug
2014-08,Utah,12958,2364,3132,87,5583,2014,Aug
2014-08,Vermont,0,1020,1177,30,2227,2014,Aug
2014-08,Virgin Islands,119,11,1,0,12,2014,Aug
2014-08,Virginia,0,16034,13675,792,30501,2014,Aug
2014-08,Washington,7650,11570,9239,867,21676,2014,Aug
2014-08,West Virginia,948,5236,5986,180,11402,2014,Aug
2014-08,Wisconsin,3164,8526,11849,388,20763,2014,Aug
2014-08,Wyoming,575,1517,1964,46,3527,2014,Aug
2014-07,Alabama,17430,11554,9544,492,21590,2014,Jul
2014-07,Alaska,237,2565,2564,109,5238,2014,Jul
2014-07,Arizona,4401,8216,5610,557,14383,2014,Jul
2014-07,Arkansas,2834,3668,3928,133,7729,2014,Jul
2014-07,California,40766,34912,24482,3254,62648,2014,Jul
2014-07,Colorado,4049,13288,10489,627,24404,2014,Jul
2014-07,Connecticut,6897,4141,1489,92,5722,2014,Jul
2014-07,Delaware,181,1301,1333,64,2698,2014,Jul
2014-07,District of Columbia,0,44,4,0,48,2014,Jul
2014-07,Florida,12265,33878,17356,1737,52971,2014,Jul
2014-07,Georgia,13895,8998,5971,261,15230,2014,Jul
2014-07,Guam,0,72,38,12,122,2014,Jul
2014-07,Hawaii,1291,0,0,0,0,2014,Jul
2014-07,Idaho,2363,1970,2823,81,4874,2014,Jul
2014-07,Illinois,60504,15798,9607,0,25405,2014,Jul
2014-07,Indiana,7651,13475,9126,555,23156,2014,Jul
2014-07,Iowa,5737,119,1606,14,1739,2014,Jul
2014-07,Kansas,1644,3884,3623,201,7708,2014,Jul
2014-07,Kentucky,232847,6375,5428,151,11954,2014,Jul
2014-07,Louisiana,0,7931,7199,489,15619,2014,Jul
2014-07,Maine,0,1995,2381,101,4477,2014,Jul
2014-07,Mariana Islands,0,0,2,0,2,2014,Jul
2014-07,Maryland,1065,1953,3534,91,5578,2014,Jul
2014-07,Massachusetts,6138,3922,2154,292,6368,2014,Jul
2014-07,Michigan,14814,7133,6479,228,13840,2014,Jul
2014-07,Minnesota,19088,6012,7192,285,13489,2014,Jul
2014-07,Mississippi,573,4733,3874,133,8740,2014,Jul
2014-07,Missouri,4364,12678,9729,570,22977,2014,Jul
2014-07,Montana,811,2111,3279,73,5463,2014,Jul
2014-07,Nebraska,2271,75,1241,10,1326,2014,Jul
2014-07,Nevada,1598,3359,2279,209,5847,2014,Jul
2014-07,New Hampshire,2668,3126,2456,61,5643,2014,Jul
2014-07,New Jersey,0,3989,2681,122,6792,2014,Jul
2014-07,New Mexico,718,3803,3193,230,7226,2014,Jul
2014-07,New York,9454,7428,9573,338,17339,2014,Jul
2014-07,North Carolina,17153,787,8442,392,9621,2014,Jul
2014-07,North Dakota,774,1150,2145,48,3343,2014,Jul
2014-07,Ohio,0,19770,14202,1000,34972,2014,Jul
2014-07,Oklahoma,0,9523,7517,644,17684,2014,Jul
2014-07,Oregon,7,7888,6998,0,14886,2014,Jul
2014-07,Pennsylvania,18465,34544,6543,0,41087,2014,Jul
2014-07,Puerto Rico,0,950,214,9,1173,2014,Jul
2014-07,Rhode Island,0,686,564,31,1281,2014,Jul
2014-07,South Carolina,7170,5453,4095,294,9842,2014,Jul
2014-07,South Dakota,7,1816,2559,134,4509,2014,Jul
2014-07,Tennessee,7937,15442,10414,0,25856,2014,Jul
2014-07,Texas,19340,32736,28145,2088,62969,2014,Jul
2014-07,Utah,14170,1990,2532,69,4591,2014,Jul
2014-07,Vermont,0,916,888,34,1838,2014,Jul
2014-07,Virgin Islands,43,13,7,0,20,2014,Jul
2014-07,Virginia,0,15727,11605,699,28031,2014,Jul
2014-07,Washington,8973,10715,7606,839,19160,2014,Jul
2014-07,West Virginia,873,4847,4587,163,9597,2014,Jul
2014-07,Wisconsin,3107,7883,7746,364,15993,2014,Jul
2014-07,Wyoming,544,1425,1691,65,3181,2014,Jul
2014-06,Alabama,15440,11437,10279,417,22133,2014,Jun
2014-06,Alaska,228,2627,2467,130,5224,2014,Jun
2014-06,Arizona,5140,8507,5496,590,14593,2014,Jun
2014-06,Arkansas,3822,3859,3788,98,7745,2014,Jun
2014-06,California,39245,34232,24557,3818,62607,2014,Jun
2014-06,Colorado,3583,12549,9343,600,22492,2014,Jun
2014-06,Connecticut,7260,4293,1647,70,6010,2014,Jun
2014-06,Delaware,194,1451,1146,62,2659,2014,Jun
2014-06,District of Columbia,0,21,1,0,22,2014,Jun
2014-06,Florida,13789,33636,17047,1569,52252,2014,Jun
2014-06,Georgia,10963,9625,6006,216,15847,2014,Jun
2014-06,Guam,0,84,42,13,139,2014,Jun
2014-06,Hawaii,1210,0,0,0,0,2014,Jun
2014-06,Idaho,3254,2220,3190,105,5515,2014,Jun
2014-06,Illinois,87691,15406,8740,0,24146,2014,Jun
2014-06,Indiana,7644,13069,8702,530,22301,2014,Jun
2014-06,Iowa,6704,146,1614,18,1778,2014,Jun
2014-06,Kansas,1582,3682,3604,172,7458,2014,Jun
2014-06,Kentucky,199326,6061,5196,157,11414,2014,Jun
2014-06,Louisiana,0,9220,6868,546,16634,2014,Jun
2014-06,Maine,0,2065,2185,95,4345,2014,Jun
2014-06,Mariana Islands,0,0,1,0,1,2014,Jun
2014-06,Maryland,986,2383,3641,91,6115,2014,Jun
2014-06,Massachusetts,6951,4060,2021,305,6386,2014,Jun
2014-06,Michigan,14346,7041,6044,242,13327,2014,Jun
2014-06,Minnesota,20821,6592,6796,288,13676,2014,Jun
2014-06,Mississippi,547,4596,3664,138,8398,2014,Jun
2014-06,Missouri,3729,13225,9673,584,23482,2014,Jun
2014-06,Montana,865,2469,3630,73,6172,2014,Jun
2014-06,Nebraska,2226,89,1144,4,1237,2014,Jun
2014-06,Nevada,2101,3695,2418,189,6302,2014,Jun
2014-06,New Hampshire,2691,3214,2561,54,5829,2014,Jun
2014-06,New Jersey,0,4018,2493,138,6649,2014,Jun
2014-06,New Mexico,795,4237,3269,208,7714,2014,Jun
2014-06,New York,6899,6991,9201,343,16535,2014,Jun
2014-06,North Carolina,18553,751,8702,360,9813,2014,Jun
2014-06,North Dakota,636,1191,2114,37,3342,2014,Jun
2014-06,Ohio,0,18471,13177,947,32595,2014,Jun
2014-06,Oklahoma,0,9705,7568,649,17922,2014,Jun
2014-06,Oregon,39,8731,7689,0,16420,2014,Jun
2014-06,Pennsylvania,16933,33261,6077,0,39338,2014,Jun
2014-06,Puerto Rico,0,930,204,16,1150,2014,Jun
2014-06,Rhode Island,0,657,487,26,1170,2014,Jun
2014-06,South Carolina,7923,5911,3745,260,9916,2014,Jun
2014-06,South Dakota,2,1794,2468,73,4335,2014,Jun
2014-06,Tennessee,7435,14563,10004,0,24567,2014,Jun
2014-06,Texas,16019,34426,27426,2067,63919,2014,Jun
2014-06,Utah,17714,2182,2654,100,4936,2014,Jun
2014-06,Vermont,0,867,787,48,1702,2014,Jun
2014-06,Virgin Islands,83,19,2,0,21,2014,Jun
2014-06,Virginia,0,14711,11017,623,26351,2014,Jun
2014-06,Washington,9081,11690,8253,825,20768,2014,Jun
2014-06,West Virginia,785,4786,4290,148,9224,2014,Jun
2014-06,Wisconsin,3528,7922,7111,349,15382,2014,Jun
2014-06,Wyoming,801,1503,1774,76,3353,2014,Jun
2014-05,Alabama,16215,12872,8807,502,22181,2014,May
2014-05,Alaska,274,2990,3161,139,6290,2014,May
2014-05,Arizona,6529,9112,6065,582,15759,2014,May
2014-05,Arkansas,6299,3931,3869,102,7902,2014,May
2014-05,California,50964,38192,26630,3879,68701,2014,May
2014-05,Colorado,5543,13775,10818,693,25286,2014,May
2014-05,Connecticut,7632,4837,1900,68,6805,2014,May
2014-05,Delaware,301,1790,1671,61,3522,2014,May
2014-05,District of Columbia,0,29,2,0,31,2014,May
2014-05,Florida,18764,35254,17504,1756,54514,2014,May
2014-05,Georgia,12827,10127,6051,301,16479,2014,May
2014-05,Guam,0,77,58,22,157,2014,May
2014-05,Hawaii,1155,0,0,0,0,2014,May
2014-05,Idaho,2327,2436,3399,91,5926,2014,May
2014-05,Illinois,64832,17848,9308,0,27156,2014,May
2014-05,Indiana,9559,15395,9454,677,25526,2014,May
2014-05,Iowa,6278,120,1659,19,1798,2014,May
2014-05,Kansas,1675,4155,3779,213,8147,2014,May
2014-05,Kentucky,214214,6668,5294,160,12122,2014,May
2014-05,Louisiana,0,9196,6921,429,16546,2014,May
2014-05,Maine,0,2546,2571,86,5203,2014,May
2014-05,Mariana Islands,0,0,0,0,0,2014,May
2014-05,Maryland,1199,2532,3877,69,6478,2014,May
2014-05,Massachusetts,6618,4713,2294,293,7300,2014,May
2014-05,Michigan,14896,8422,6988,299,15709,2014,May
2014-05,Minnesota,18283,7285,7633,332,15250,2014,May
2014-05,Mississippi,582,5337,3706,146,9189,2014,May
2014-05,Missouri,3880,14385,9810,590,24785,2014,May
2014-05,Montana,956,2516,3735,80,6331,2014,May
2014-05,Nebraska,2534,107,1323,12,1442,2014,May
2014-05,Nevada,1779,3740,2535,217,6492,2014,May
2014-05,New Hampshire,3393,3831,2802,61,6694,2014,May
2014-05,New Jersey,0,4856,2871,181,7908,2014,May
2014-05,New Mexico,691,4577,3520,270,8367,2014,May
2014-05,New York,6387,8008,10682,444,19134,2014,May
2014-05,North Carolina,20461,767,8557,394,9718,2014,May
2014-05,North Dakota,815,1496,2549,59,4104,2014,May
2014-05,Ohio,0,21891,14553,1013,37457,2014,May
2014-05,Oklahoma,0,9927,7324,684,17935,2014,May
2014-05,Oregon,40,9636,8199,0,17835,2014,May
2014-05,Pennsylvania,18372,38001,6871,0,44872,2014,May
2014-05,Puerto Rico,0,1084,232,5,1321,2014,May
2014-05,Rhode Island,0,745,592,35,1372,2014,May
2014-05,South Carolina,8671,6444,3875,310,10629,2014,May
2014-05,South Dakota,5,1992,2659,71,4722,2014,May
2014-05,Tennessee,7199,15607,10039,0,25646,2014,May
2014-05,Texas,17072,37264,29032,2209,68505,2014,May
2014-05,Utah,20462,2454,2854,98,5406,2014,May
2014-05,Vermont,0,977,1014,62,2053,2014,May
2014-05,Virgin Islands,82,8,3,0,11,2014,May
2014-05,Virginia,0,15597,11102,686,27385,2014,May
2014-05,Washington,12897,12517,8554,907,21978,2014,May
2014-05,West Virginia,911,5563,4878,186,10627,2014,May
2014-05,Wisconsin,4159,9269,8182,415,17866,2014,May
2014-05,Wyoming,931,1732,1972,68,3772,2014,May
2014-04,Alabama,17498,13842,10285,571,24698,2014,Apr
2014-04,Alaska,345,3293,3805,246,7344,2014,Apr
2014-04,Arizona,5848,10229,6786,644,17659,2014,Apr
2014-04,Arkansas,4526,4509,4705,137,9351,2014,Apr
2014-04,California,58879,40847,29602,4030,74479,2014,Apr
2014-04,Colorado,6343,14888,11741,793,27422,2014,Apr
2014-04,Connecticut,13030,4885,2714,75,7674,2014,Apr
2014-04,Delaware,288,1449,957,62,2468,2014,Apr
2014-04,District of Columbia,0,29,5,0,34,2014,Apr
2014-04,Florida,31586,37470,19213,1728,58411,2014,Apr
2014-04,Georgia,15172,10794,6894,318,18006,2014,Apr
2014-04,Guam,0,107,64,31,202,2014,Apr
2014-04,Hawaii,1597,0,0,0,0,2014,Apr
2014-04,Idaho,3337,2524,3506,103,6133,2014,Apr
2014-04,Illinois,72734,21131,11333,0,32464,2014,Apr
2014-04,Indiana,12335,16956,11235,801,28992,2014,Apr
2014-04,Iowa,7746,183,2379,17,2579,2014,Apr
2014-04,Kansas,2032,4961,4849,290,10100,2014,Apr
2014-04,Kentucky,255799,7460,6916,148,14524,2014,Apr
2014-04,Louisiana,0,9614,7205,510,17329,2014,Apr
2014-04,Maine,0,3028,3280,117,6425,2014,Apr
2014-04,Mariana Islands,0,0,2,0,2,2014,Apr
2014-04,Maryland,1804,4065,4397,51,8513,2014,Apr
2014-04,Massachusetts,7412,5277,2791,434,8502,2014,Apr
2014-04,Michigan,16595,10199,8974,324,19497,2014,Apr
2014-04,Minnesota,23552,9635,11501,422,21558,2014,Apr
2014-04,Mississippi,785,5471,4232,177,9880,2014,Apr
2014-04,Missouri,5066,16394,13060,697,30151,2014,Apr
2014-04,Montana,1312,2846,4260,104,7210,2014,Apr
2014-04,Nebraska,3488,114,1530,20,1664,2014,Apr
2014-04,Nevada,1999,4030,2969,223,7222,2014,Apr
2014-04,New Hampshire,4018,4324,3113,93,7530,2014,Apr
2014-04,New Jersey,0,5108,3208,156,8472,2014,Apr
2014-04,New Mexico,743,4751,3793,258,8802,2014,Apr
2014-04,New York,19290,8812,14214,682,23708,2014,Apr
2014-04,North Carolina,44082,899,9966,496,11361,2014,Apr
2014-04,North Dakota,881,1931,3158,62,5151,2014,Apr
2014-04,Ohio,0,26196,18183,1228,45607,2014,Apr
2014-04,Oklahoma,0,11910,9474,827,22211,2014,Apr
2014-04,Oregon,20,10106,9347,0,19453,2014,Apr
2014-04,Pennsylvania,22034,44546,7942,0,52488,2014,Apr
2014-04,Puerto Rico,0,965,183,19,1167,2014,Apr
2014-04,Rhode Island,0,846,664,46,1556,2014,Apr
2014-04,South Carolina,6671,7753,4816,372,12941,2014,Apr
2014-04,South Dakota,9,2219,3235,89,5543,2014,Apr
2014-04,Tennessee,7903,16972,11316,0,28288,2014,Apr
2014-04,Texas,18481,38657,30379,2127,71163,2014,Apr
2014-04,Utah,23149,2560,3154,110,5824,2014,Apr
2014-04,Vermont,0,1485,1527,62,3074,2014,Apr
2014-04,Virgin Islands,77,24,0,0,24,2014,Apr
2014-04,Virginia,0,17184,13113,740,31037,2014,Apr
2014-04,Washington,18752,13876,9961,1074,24911,2014,Apr
2014-04,West Virginia,1150,6345,6087,198,12630,2014,Apr
2014-04,Wisconsin,5940,12764,12744,510,26018,2014,Apr
2014-04,Wyoming,617,2005,2209,77,4291,2014,Apr
2014-03,Alabama,21849,17289,13141,691,31121,2014,Mar
2014-03,Alaska,259,2886,3330,209,6425,2014,Mar
2014-03,Arizona,3704,12720,8253,629,21602,2014,Mar
2014-03,Arkansas,4992,6054,5924,135,12113,2014,Mar
2014-03,California,52153,45089,34352,4833,84274,2014,Mar
2014-03,Colorado,4661,18478,13652,766,32896,2014,Mar
2014-03,Connecticut,17496,6563,12310,171,19044,2014,Mar
2014-03,Delaware,334,1809,1219,70,3098,2014,Mar
2014-03,District of Columbia,0,45,3,0,48,2014,Mar
2014-03,Florida,32405,42745,23125,1819,67689,2014,Mar
2014-03,Georgia,16042,15033,10064,364,25461,2014,Mar
2014-03,Guam,0,105,77,19,201,2014,Mar
2014-03,Hawaii,1333,0,0,0,0,2014,Mar
2014-03,Idaho,5538,3166,4346,135,7647,2014,Mar
2014-03,Illinois,102752,26637,15182,0,41819,2014,Mar
2014-03,Indiana,12438,23024,15040,1085,39149,2014,Mar
2014-03,Iowa,9748,237,3580,22,3839,2014,Mar
2014-03,Kansas,2493,6240,6138,291,12669,2014,Mar
2014-03,Kentucky,257321,10541,8970,216,19727,2014,Mar
2014-03,Louisiana,0,12132,9994,553,22679,2014,Mar
2014-03,Maine,0,3478,3487,158,7123,2014,Mar
2014-03,Mariana Islands,0,0,0,0,0,2014,Mar
2014-03,Maryland,2843,8197,5712,70,13979,2014,Mar
2014-03,Massachusetts,9160,6794,3607,406,10807,2014,Mar
2014-03,Michigan,16900,13134,11534,431,25099,2014,Mar
2014-03,Minnesota,25822,10604,12475,533,23612,2014,Mar
2014-03,Mississippi,758,7582,6093,182,13857,2014,Mar
2014-03,Missouri,5224,20739,15823,876,37438,2014,Mar
2014-03,Montana,1270,3307,4683,110,8100,2014,Mar
2014-03,Nebraska,4128,121,2079,26,2226,2014,Mar
2014-03,Nevada,2428,4727,3495,305,8527,2014,Mar
2014-03,New Hampshire,3631,5060,3695,106,8861,2014,Mar
2014-03,New Jersey,0,5486,4034,205,9725,2014,Mar
2014-03,New Mexico,715,5928,5200,305,11433,2014,Mar
2014-03,New York,7078,9717,15665,913,26295,2014,Mar
2014-03,North Carolina,522188,1054,13571,528,15153,2014,Mar
2014-03,North Dakota,583,1966,3397,78,5441,2014,Mar
2014-03,Ohio,0,32656,21426,1535,55617,2014,Mar
2014-03,Oklahoma,0,13697,11271,801,25769,2014,Mar
2014-03,Oregon,106,12411,11829,0,24240,2014,Mar
2014-03,Pennsylvania,25102,57940,10351,0,68291,2014,Mar
2014-03,Puerto Rico,0,1167,194,4,1365,2014,Mar
2014-03,Rhode Island,0,1106,912,51,2069,2014,Mar
2014-03,South Carolina,9518,10077,6225,451,16753,2014,Mar
2014-03,South Dakota,8,2857,4061,105,7023,2014,Mar
2014-03,Tennessee,7488,19944,15014,0,34958,2014,Mar
2014-03,Texas,26007,49169,38758,2453,90380,2014,Mar
2014-03,Utah,14828,3322,3888,117,7327,2014,Mar
2014-03,Vermont,0,1615,1563,71,3249,2014,Mar
2014-03,Virgin Islands,90,17,1,0,18,2014,Mar
2014-03,Virginia,0,23015,16781,904,40700,2014,Mar
2014-03,Washington,12531,16516,12072,1185,29773,2014,Mar
2014-03,West Virginia,1336,8542,7716,269,16527,2014,Mar
2014-03,Wisconsin,6122,14797,15233,581,30611,2014,Mar
2014-03,Wyoming,523,2267,2379,82,4728,2014,Mar
2014-02,Alabama,21593,19710,14439,679,34828,2014,Feb
2014-02,Alaska,115,2697,2652,173,5522,2014,Feb
2014-02,Arizona,3487,13149,8294,631,22074,2014,Feb
2014-02,Arkansas,3910,7312,7375,127,14814,2014,Feb
2014-02,California,36848,39048,29728,4280,73056,2014,Feb
2014-02,Colorado,4949,17215,13037,661,30913,2014,Feb
2014-02,Connecticut,12879,5246,11351,149,16746,2014,Feb
2014-02,Delaware,326,1660,1022,95,2777,2014,Feb
2014-02,District of Columbia,0,25,2,0,27,2014,Feb
2014-02,Florida,20119,46802,25174,1614,73590,2014,Feb
2014-02,Georgia,14467,17171,10809,355,28335,2014,Feb
2014-02,Guam,0,88,46,23,157,2014,Feb
2014-02,Hawaii,1222,0,0,0,0,2014,Feb
2014-02,Idaho,2266,3263,4333,136,7732,2014,Feb
2014-02,Illinois,78016,23448,13449,0,36897,2014,Feb
2014-02,Indiana,12042,22970,14166,904,38040,2014,Feb
2014-02,Iowa,9818,206,2939,27,3172,2014,Feb
2014-02,Kansas,1737,7199,6496,313,14008,2014,Feb
2014-02,Kentucky,227921,13082,10425,214,23721,2014,Feb
2014-02,Louisiana,0,13147,10479,467,24093,2014,Feb
2014-02,Maine,0,3221,3082,156,6459,2014,Feb
2014-02,Mariana Islands,0,0,1,0,1,2014,Feb
2014-02,Maryland,2983,10156,5446,47,15649,2014,Feb
2014-02,Massachusetts,7997,5471,2679,346,8496,2014,Feb
2014-02,Michigan,12488,11886,9984,352,22222,2014,Feb
2014-02,Minnesota,20865,8845,9013,437,18295,2014,Feb
2014-02,Mississippi,808,9222,6691,199,16112,2014,Feb
2014-02,Missouri,4154,21678,16291,825,38794,2014,Feb
2014-02,Montana,950,2798,4003,117,6918,2014,Feb
2014-02,Nebraska,3945,113,2129,16,2258,2014,Feb
2014-02,Nevada,2261,5089,3284,210,8583,2014,Feb
2014-02,New Hampshire,2718,4270,3080,89,7439,2014,Feb
2014-02,New Jersey,0,4327,3290,145,7762,2014,Feb
2014-02,New Mexico,586,5979,4999,271,11249,2014,Feb
2014-02,New York,4043,8553,13614,731,22898,2014,Feb
2014-02,North Carolina,199748,1082,15014,504,16600,2014,Feb
2014-02,North Dakota,1291,1910,2814,62,4786,2014,Feb
2014-02,Ohio,0,32864,19732,1373,53969,2014,Feb
2014-02,Oklahoma,0,15122,11260,740,27122,2014,Feb
2014-02,Oregon,38,12334,10825,0,23159,2014,Feb
2014-02,Pennsylvania,19168,47511,10231,0,57742,2014,Feb
2014-02,Puerto Rico,0,1140,182,15,1337,2014,Feb
2014-02,Rhode Island,0,996,718,31,1745,2014,Feb
2014-02,South Carolina,6641,11484,6181,281,17946,2014,Feb
2014-02,South Dakota,5,3008,4013,92,7113,2014,Feb
2014-02,Tennessee,10826,25694,17965,0,43659,2014,Feb
2014-02,Texas,26564,55417,41550,2271,99238,2014,Feb
2014-02,Utah,12811,3584,3976,85,7645,2014,Feb
2014-02,Vermont,0,1662,1337,68,3067,2014,Feb
2014-02,Virgin Islands,88,17,3,0,20,2014,Feb
2014-02,Virginia,0,24248,16694,1131,42073,2014,Feb
2014-02,Washington,10915,15785,12011,1248,29044,2014,Feb
2014-02,West Virginia,942,8737,7936,241,16914,2014,Feb
2014-02,Wisconsin,4910,13860,11750,451,26061,2014,Feb
2014-02,Wyoming,508,2187,2231,73,4491,2014,Feb
2014-01,Alabama,21881,12371,12790,579,25740,2014,Jan
2014-01,Alaska,169,1994,2128,202,4324,2014,Jan
2014-01,Arizona,4382,9833,7135,563,17531,2014,Jan
2014-01,Arkansas,4330,4337,5573,112,10022,2014,Jan
2014-01,California,33962,33834,27585,3822,65241,2014,Jan
2014-01,Colorado,6273,14078,11498,678,26254,2014,Jan
2014-01,Connecticut,16334,5330,6693,119,12142,2014,Jan
2014-01,Delaware,61,1325,943,80,2348,2014,Jan
2014-01,District of Columbia,0,48,3,0,51,2014,Jan
2014-01,Florida,16053,37372,22370,1671,61413,2014,Jan
2014-01,Georgia,14232,9861,8510,303,18674,2014,Jan
2014-01,Guam,0,91,52,30,173,2014,Jan
2014-01,Hawaii,1337,0,0,0,0,2014,Jan
2014-01,Idaho,1923,2265,3193,113,5571,2014,Jan
2014-01,Illinois,89150,20164,11190,0,31354,2014,Jan
2014-01,Indiana,11324,14854,10418,908,26180,2014,Jan
2014-01,Iowa,10269,214,2413,24,2651,2014,Jan
2014-01,Kansas,1706,5257,5907,247,11411,2014,Jan
2014-01,Kentucky,240641,7116,6657,200,13973,2014,Jan
2014-01,Louisiana,0,9395,10294,495,20184,2014,Jan
2014-01,Maine,0,2476,2616,122,5214,2014,Jan
2014-01,Mariana Islands,0,0,0,0,0,2014,Jan
2014-01,Maryland,3090,13512,4859,35,18406,2014,Jan
2014-01,Massachusetts,9297,5374,2727,367,8468,2014,Jan
2014-01,Michigan,14010,7388,7414,355,15157,2014,Jan
2014-01,Minnesota,18556,7500,7101,430,15031,2014,Jan
2014-01,Mississippi,688,5347,5946,166,11459,2014,Jan
2014-01,Missouri,3987,16170,12823,840,29833,2014,Jan
2014-01,Montana,999,2280,3252,75,5607,2014,Jan
2014-01,Nebraska,3945,93,1966,13,2072,2014,Jan
2014-01,Nevada,1994,3683,2761,222,6666,2014,Jan
2014-01,New Hampshire,3182,3767,2830,85,6682,2014,Jan
2014-01,New Jersey,0,4461,3337,156,7954,2014,Jan
2014-01,New Mexico,443,4256,3940,222,8418,2014,Jan
2014-01,New York,4196,8356,11964,704,21024,2014,Jan
2014-01,North Carolina,24661,743,11645,457,12845,2014,Jan
2014-01,North Dakota,1205,1441,2621,62,4124,2014,Jan
2014-01,Ohio,0,21851,14893,1266,38010,2014,Jan
2014-01,Oklahoma,0,11442,10339,763,22544,2014,Jan
2014-01,Oregon,47,10184,9273,0,19457,2014,Jan
2014-01,Pennsylvania,21228,207,48368,153,48728,2014,Jan
2014-01,Puerto Rico,0,1132,215,10,1357,2014,Jan
2014-01,Rhode Island,0,802,676,21,1499,2014,Jan
2014-01,South Carolina,7415,7312,5263,308,12883,2014,Jan
2014-01,South Dakota,0,2283,3302,79,5664,2014,Jan
2014-01,Tennessee,13942,17208,13754,0,30962,2014,Jan
2014-01,Texas,39851,39174,36808,2083,78065,2014,Jan
2014-01,Utah,15423,2583,3106,117,5806,2014,Jan
2014-01,Vermont,0,971,1067,53,2091,2014,Jan
2014-01,Virgin Islands,111,18,2,0,20,2014,Jan
2014-01,Virginia,0,16759,14172,716,31647,2014,Jan
2014-01,Washington,11997,13899,10505,1085,25489,2014,Jan
2014-01,West Virginia,770,5748,5726,233,11707,2014,Jan
2014-01,Wisconsin,4486,9720,8491,472,18683,2014,Jan
2014-01,Wyoming,505,1504,1816,87,3407,2014,Jan
2013-12,Alabama,21065,20186,30523,738,51447,2013,Dec
2013-12,Alaska,155,3036,4064,193,7293,2013,Dec
2013-12,Arizona,3482,13122,12723,632,26477,2013,Dec
2013-12,Arkansas,2811,6292,13463,123,19878,2013,Dec
2013-12,California,32778,34360,70609,68,105037,2013,Dec
2013-12,Colorado,3148,18259,20072,807,39138,2013,Dec
2013-12,Connecticut,12013,5120,4206,162,9488,2013,Dec
2013-12,Delaware,98,1618,1871,97,3586,2013,Dec
2013-12,District of Columbia,0,32,3,0,35,2013,Dec
2013-12,Florida,12672,44668,38782,1742,85192,2013,Dec
2013-12,Georgia,12437,16043,22996,347,39386,2013,Dec
2013-12,Guam,0,71,49,16,136,2013,Dec
2013-12,Hawaii,1401,0,0,0,0,2013,Dec
2013-12,Idaho,2236,3677,6904,140,10721,2013,Dec
2013-12,Illinois,47020,23671,19326,0,42997,2013,Dec
2013-12,Indiana,9562,20168,21557,841,42566,2013,Dec
2013-12,Iowa,6619,217,5671,17,5905,2013,Dec
2013-12,Kansas,1816,6785,11288,270,18343,2013,Dec
2013-12,Kentucky,197781,11500,17782,251,29533,2013,Dec
2013-12,Louisiana,0,14000,25519,522,40041,2013,Dec
2013-12,Maine,0,2798,4518,114,7430,2013,Dec
2013-12,Mariana Islands,0,0,2,0,2,2013,Dec
2013-12,Maryland,2582,10340,8061,52,18453,2013,Dec
2013-12,Massachusetts,7829,5005,3082,345,8432,2013,Dec
2013-12,Michigan,10790,9884,16140,361,26385,2013,Dec
2013-12,Minnesota,16414,8191,12738,452,21381,2013,Dec
2013-12,Mississippi,657,8172,17156,192,25520,2013,Dec
2013-12,Missouri,3323,20002,24195,813,45010,2013,Dec
2013-12,Montana,687,3282,6369,81,9732,2013,Dec
2013-12,Nebraska,3976,157,4419,13,4589,2013,Dec
2013-12,Nevada,1928,5141,4866,222,10229,2013,Dec
2013-12,New Hampshire,2431,4472,3985,74,8531,2013,Dec
2013-12,New Jersey,0,4332,4632,154,9118,2013,Dec
2013-12,New Mexico,717,5833,6878,249,12960,2013,Dec
2013-12,New York,2828,8013,20786,689,29488,2013,Dec
2013-12,North Carolina,24231,1171,28667,472,30310,2013,Dec
2013-12,North Dakota,482,1823,4293,67,6183,2013,Dec
2013-12,Ohio,0,31976,30852,1252,64080,2013,Dec
2013-12,Oklahoma,0,14536,19621,811,34968,2013,Dec
2013-12,Oregon,44,12103,14426,0,26529,2013,Dec
2013-12,Pennsylvania,18894,20,68271,252,68543,2013,Dec
2013-12,Puerto Rico,0,1032,218,11,1261,2013,Dec
2013-12,Rhode Island,0,846,904,36,1786,2013,Dec
2013-12,South Carolina,4912,10335,13522,411,24268,2013,Dec
2013-12,South Dakota,1,2749,5832,83,8664,2013,Dec
2013-12,Tennessee,9866,24107,29742,0,53849,2013,Dec
2013-12,Texas,15969,56566,78068,2290,136924,2013,Dec
2013-12,Utah,11736,4493,7958,126,12577,2013,Dec
2013-12,Vermont,0,1140,1629,63,2832,2013,Dec
2013-12,Virgin Islands,58,32,3,0,35,2013,Dec
2013-12,Virginia,0,22960,27395,989,51344,2013,Dec
2013-12,Washington,9698,17123,16363,1167,34653,2013,Dec
2013-12,West Virginia,568,9064,13497,297,22858,2013,Dec
2013-12,Wisconsin,3929,12457,14499,517,27473,2013,Dec
2013-12,Wyoming,582,2439,3363,67,5869,2013,Dec
2013-11,Alabama,15409,14646,22547,508,37701,2013,Nov
2013-11,Alaska,253,2472,3482,168,6122,2013,Nov
2013-11,Arizona,3580,10029,10055,526,20610,2013,Nov
2013-11,Arkansas,2971,4547,12292,98,16937,2013,Nov
2013-11,California,33427,31163,43714,84,74961,2013,Nov
2013-11,Colorado,4029,15843,16429,643,32915,2013,Nov
2013-11,Connecticut,13763,4856,3780,78,8714,2013,Nov
2013-11,Delaware,80,1335,1809,60,3204,2013,Nov
2013-11,District of Columbia,0,29,5,0,34,2013,Nov
2013-11,Florida,11371,37545,30492,1571,69608,2013,Nov
2013-11,Georgia,10446,11071,16419,310,27800,2013,Nov
2013-11,Guam,0,55,33,11,99,2013,Nov
2013-11,Hawaii,1103,0,0,0,0,2013,Nov
2013-11,Idaho,1670,2493,5285,82,7860,2013,Nov
2013-11,Illinois,51259,20356,18330,0,38686,2013,Nov
2013-11,Indiana,11046,17093,21064,744,38901,2013,Nov
2013-11,Iowa,6490,196,5246,22,5464,2013,Nov
2013-11,Kansas,1338,5534,10120,236,15890,2013,Nov
2013-11,Kentucky,179357,8074,15492,208,23774,2013,Nov
2013-11,Louisiana,0,9894,20151,426,30471,2013,Nov
2013-11,Maine,0,2363,5048,106,7517,2013,Nov
2013-11,Mariana Islands,0,0,5,0,5,2013,Nov
2013-11,Maryland,2306,7478,8311,45,15834,2013,Nov
2013-11,Massachusetts,9537,4918,3583,301,8802,2013,Nov
2013-11,Michigan,12196,8496,18252,257,27005,2013,Nov
2013-11,Minnesota,14604,7482,14683,326,22491,2013,Nov
2013-11,Mississippi,595,5937,14525,166,20628,2013,Nov
2013-11,Missouri,3222,15610,23535,617,39762,2013,Nov
2013-11,Montana,699,2506,5461,80,8047,2013,Nov
2013-11,Nebraska,2946,100,3706,11,3817,2013,Nov
2013-11,Nevada,1403,4165,3962,199,8326,2013,Nov
2013-11,New Hampshire,2499,3898,3930,53,7881,2013,Nov
2013-11,New Jersey,0,4849,5050,132,10031,2013,Nov
2013-11,New Mexico,701,4612,5718,210,10540,2013,Nov
2013-11,New York,2131,7289,22304,530,30123,2013,Nov
2013-11,North Carolina,21573,858,21936,380,23174,2013,Nov
2013-11,North Dakota,1289,1499,4459,52,6010,2013,Nov
2013-11,Ohio,0,26725,29854,962,57541,2013,Nov
2013-11,Oklahoma,0,12481,17046,769,30296,2013,Nov
2013-11,Oregon,61,10276,12558,0,22834,2013,Nov
2013-11,Pennsylvania,18342,25,70428,184,70637,2013,Nov
2013-11,Puerto Rico,0,1218,235,10,1463,2013,Nov
2013-11,Rhode Island,0,865,904,23,1792,2013,Nov
2013-11,South Carolina,4849,7799,10468,310,18577,2013,Nov
2013-11,South Dakota,1,2111,5697,81,7889,2013,Nov
2013-11,Tennessee,8815,19267,24267,0,43534,2013,Nov
2013-11,Texas,16185,43195,57710,1701,102606,2013,Nov
2013-11,Utah,11516,3132,6023,103,9258,2013,Nov
2013-11,Vermont,0,999,1905,46,2950,2013,Nov
2013-11,Virgin Islands,74,12,0,0,12,2013,Nov
2013-11,Virginia,0,19170,24822,926,44918,2013,Nov
2013-11,Washington,8822,13521,14411,901,28833,2013,Nov
2013-11,West Virginia,400,6087,13313,187,19587,2013,Nov
2013-11,Wisconsin,4959,10913,18644,389,29946,2013,Nov
2013-11,Wyoming,342,1802,2772,66,4640,2013,Nov
2013-10,Alabama,18118,12230,15479,461,28170,2013,Oct
2013-10,Alaska,204,3039,4016,220,7275,2013,Oct
2013-10,Arizona,4487,8719,7750,483,16952,2013,Oct
2013-10,Arkansas,2696,3948,8699,73,12720,2013,Oct
2013-10,California,45148,30693,37814,132,68639,2013,Oct
2013-10,Colorado,5462,13346,14105,548,27999,2013,Oct
2013-10,Connecticut,12550,4324,3224,78,7626,2013,Oct
2013-10,Delaware,170,1336,1326,67,2729,2013,Oct
2013-10,District of Columbia,0,35,1,1,37,2013,Oct
2013-10,Florida,15620,34006,23276,1372,58654,2013,Oct
2013-10,Georgia,11367,9429,12015,217,21661,2013,Oct
2013-10,Guam,0,66,51,6,123,2013,Oct
2013-10,Hawaii,1325,0,0,0,0,2013,Oct
2013-10,Idaho,2091,2190,4920,78,7188,2013,Oct
2013-10,Illinois,69461,17090,14128,0,31218,2013,Oct
2013-10,Indiana,12492,14671,14624,620,29915,2013,Oct
2013-10,Iowa,7659,212,3696,24,3932,2013,Oct
2013-10,Kansas,1428,4983,7034,203,12220,2013,Oct
2013-10,Kentucky,182023,6821,10102,146,17069,2013,Oct
2013-10,Louisiana,0,8904,15354,397,24655,2013,Oct
2013-10,Maine,0,2664,6369,88,9121,2013,Oct
2013-10,Mariana Islands,0,0,2,0,2,2013,Oct
2013-10,Maryland,775,13453,5973,81,19507,2013,Oct
2013-10,Massachusetts,11426,4844,3209,270,8323,2013,Oct
2013-10,Michigan,17310,8034,14119,251,22404,2013,Oct
2013-10,Minnesota,16477,7769,17272,328,25369,2013,Oct
2013-10,Mississippi,611,5495,8248,154,13897,2013,Oct
2013-10,Missouri,3818,15300,18695,517,34512,2013,Oct
2013-10,Montana,1092,2378,6121,85,8584,2013,Oct
2013-10,Nebraska,3499,74,2782,19,2875,2013,Oct
2013-10,Nevada,1682,3873,3221,195,7289,2013,Oct
2013-10,New Hampshire,3380,3877,3981,45,7903,2013,Oct
2013-10,New Jersey,0,5067,4084,190,9341,2013,Oct
2013-10,New Mexico,844,4658,4803,230,9691,2013,Oct
2013-10,New York,1748,7890,19394,516,27800,2013,Oct
2013-10,North Carolina,18592,737,15688,322,16747,2013,Oct
2013-10,North Dakota,1243,1406,5451,54,6911,2013,Oct
2013-10,Ohio,0,23348,20561,847,44756,2013,Oct
2013-10,Oklahoma,0,9902,11757,536,22195,2013,Oct
2013-10,Oregon,19,9127,10336,0,19463,2013,Oct
2013-10,Pennsylvania,20253,16,58745,186,58947,2013,Oct
2013-10,Puerto Rico,0,1160,275,14,1449,2013,Oct
2013-10,Rhode Island,0,863,837,23,1723,2013,Oct
2013-10,South Carolina,5627,6311,6978,241,13530,2013,Oct
2013-10,South Dakota,1,1873,6055,64,7992,2013,Oct
2013-10,Tennessee,9869,15858,16070,0,31928,2013,Oct
2013-10,Texas,26877,36720,44769,1455,82944,2013,Oct
2013-10,Utah,10647,2305,3902,72,6279,2013,Oct
2013-10,Vermont,0,1040,1820,48,2908,2013,Oct
2013-10,Virgin Islands,73,22,1,0,23,2013,Oct
2013-10,Virginia,0,17306,18458,859,36623,2013,Oct
2013-10,Washington,10334,13581,12684,814,27079,2013,Oct
2013-10,West Virginia,357,5791,9447,177,15415,2013,Oct
2013-10,Wisconsin,6060,11776,17109,414,29299,2013,Oct
2013-10,Wyoming,366,1445,2143,51,3639,2013,Oct
2013-09,Alabama,16722,11406,13077,566,25049,2013,Sep
2013-09,Alaska,176,2152,3073,132,5357,2013,Sep
2013-09,Arizona,4013,8488,7654,491,16633,2013,Sep
2013-09,Arkansas,2518,3773,6273,70,10116,2013,Sep
2013-09,California,36741,27422,39102,75,66599,2013,Sep
2013-09,Colorado,4764,12795,12751,515,26061,2013,Sep
2013-09,Connecticut,13090,4649,3859,62,8570,2013,Sep
2013-09,Delaware,231,1106,1075,39,2220,2013,Sep
2013-09,District of Columbia,0,33,3,0,36,2013,Sep
2013-09,Florida,14714,31866,20815,1440,54121,2013,Sep
2013-09,Georgia,10731,8385,8957,213,17555,2013,Sep
2013-09,Guam,0,53,29,14,96,2013,Sep
2013-09,Hawaii,1196,0,0,0,0,2013,Sep
2013-09,Idaho,2050,2136,4609,78,6823,2013,Sep
2013-09,Illinois,40089,14147,12860,0,27007,2013,Sep
2013-09,Indiana,12443,12956,12954,576,26486,2013,Sep
2013-09,Iowa,7423,153,3166,20,3339,2013,Sep
2013-09,Kansas,1930,4069,5993,208,10270,2013,Sep
2013-09,Kentucky,35823,6237,7751,141,14129,2013,Sep
2013-09,Louisiana,0,10217,15969,419,26605,2013,Sep
2013-09,Maine,0,2613,4902,84,7599,2013,Sep
2013-09,Mariana Islands,0,0,1,0,1,2013,Sep
2013-09,Maryland,1136,38055,9912,221,48188,2013,Sep
2013-09,Massachusetts,11461,4096,2624,274,6994,2013,Sep
2013-09,Michigan,13994,7795,13428,275,21498,2013,Sep
2013-09,Minnesota,15399,7279,16139,313,23731,2013,Sep
2013-09,Mississippi,530,4832,6489,134,11455,2013,Sep
2013-09,Missouri,3569,14101,14257,536,28894,2013,Sep
2013-09,Montana,911,2288,4940,61,7289,2013,Sep
2013-09,Nebraska,2960,68,2256,9,2333,2013,Sep
2013-09,Nevada,1399,3358,3109,176,6643,2013,Sep
2013-09,New Hampshire,3190,3553,3355,46,6954,2013,Sep
2013-09,New Jersey,0,4726,3189,176,8091,2013,Sep
2013-09,New Mexico,693,3946,4090,176,8212,2013,Sep
2013-09,New York,1842,7198,16803,688,24689,2013,Sep
2013-09,North Carolina,16506,578,12550,324,13452,2013,Sep
2013-09,North Dakota,675,1466,4170,50,5686,2013,Sep
2013-09,Ohio,0,20526,18142,765,39433,2013,Sep
2013-09,Oklahoma,0,8639,9982,503,19124,2013,Sep
2013-09,Oregon,51,8831,10864,0,19695,2013,Sep
2013-09,Pennsylvania,17132,16,52691,172,52879,2013,Sep
2013-09,Puerto Rico,0,1162,269,10,1441,2013,Sep
2013-09,Rhode Island,0,759,715,20,1494,2013,Sep
2013-09,South Carolina,6602,5615,5945,180,11740,2013,Sep
2013-09,South Dakota,3,1808,4431,75,6314,2013,Sep
2013-09,Tennessee,10865,14814,13908,0,28722,2013,Sep
2013-09,Texas,17342,33690,45571,1469,80730,2013,Sep
2013-09,Utah,12193,2292,3782,44,6118,2013,Sep
2013-09,Vermont,0,1093,1553,35,2681,2013,Sep
2013-09,Virgin Islands,73,17,3,0,20,2013,Sep
2013-09,Virginia,0,15952,16794,761,33507,2013,Sep
2013-09,Washington,8652,11904,11700,775,24379,2013,Sep
2013-09,West Virginia,221,5311,7849,179,13339,2013,Sep
2013-09,Wisconsin,5188,11423,14573,348,26344,2013,Sep
2013-09,Wyoming,481,1533,2336,67,3936,2013,Sep
2013-08,Alabama,17470,14310,13402,350,28062,2013,Aug
2013-08,Alaska,207,2743,3827,150,6720,2013,Aug
2013-08,Arizona,8204,9868,8476,457,18801,2013,Aug
2013-08,Arkansas,8798,4405,6128,73,10606,2013,Aug
2013-08,California,39311,31020,39974,74,71068,2013,Aug
2013-08,Colorado,9508,12739,12081,485,25305,2013,Aug
2013-08,Connecticut,14977,5169,3252,73,8494,2013,Aug
2013-08,Delaware,184,1196,1032,45,2273,2013,Aug
2013-08,District of Columbia,0,32,2,0,34,2013,Aug
2013-08,Florida,18883,35828,20307,1409,57544,2013,Aug
2013-08,Georgia,11372,10115,8861,216,19192,2013,Aug
2013-08,Guam,0,58,38,20,116,2013,Aug
2013-08,Hawaii,1283,0,0,0,0,2013,Aug
2013-08,Idaho,2172,2483,4221,60,6764,2013,Aug
2013-08,Illinois,55088,16360,12936,0,29296,2013,Aug
2013-08,Indiana,20615,14264,12775,597,27636,2013,Aug
2013-08,Iowa,5715,223,2519,17,2759,2013,Aug
2013-08,Kansas,2762,4823,5852,172,10847,2013,Aug
2013-08,Kentucky,7118,7225,8437,134,15796,2013,Aug
2013-08,Louisiana,0,10247,12044,410,22701,2013,Aug
2013-08,Maine,0,2589,3687,70,6346,2013,Aug
2013-08,Mariana Islands,0,0,0,0,0,2013,Aug
2013-08,Maryland,64,7716,6779,112,14607,2013,Aug
2013-08,Massachusetts,12954,4820,3034,365,8219,2013,Aug
2013-08,Michigan,15044,7767,10728,245,18740,2013,Aug
2013-08,Minnesota,14625,7706,12119,306,20131,2013,Aug
2013-08,Mississippi,616,6169,7080,154,13403,2013,Aug
2013-08,Missouri,3392,16625,14656,505,31786,2013,Aug
2013-08,Montana,1124,3067,4888,108,8063,2013,Aug
2013-08,Nebraska,3152,92,2088,9,2189,2013,Aug
2013-08,Nevada,1511,3906,3176,195,7277,2013,Aug
2013-08,New Hampshire,2554,3823,3191,55,7069,2013,Aug
2013-08,New Jersey,0,6036,3631,198,9865,2013,Aug
2013-08,New Mexico,710,4583,4243,217,9043,2013,Aug
2013-08,New York,2164,7552,12961,465,20978,2013,Aug
2013-08,North Carolina,17404,1125,13357,322,14804,2013,Aug
2013-08,North Dakota,801,1390,3155,37,4582,2013,Aug
2013-08,Ohio,0,21681,16535,723,38939,2013,Aug
2013-08,Oklahoma,0,11047,10731,469,22247,2013,Aug
2013-08,Oregon,16,9292,9196,0,18488,2013,Aug
2013-08,Pennsylvania,17850,29,52638,170,52837,2013,Aug
2013-08,Puerto Rico,0,1292,209,10,1511,2013,Aug
2013-08,Rhode Island,0,827,676,15,1518,2013,Aug
2013-08,South Carolina,9712,6962,6587,168,13717,2013,Aug
2013-08,South Dakota,9,1861,3638,50,5549,2013,Aug
2013-08,Tennessee,7673,16500,14236,0,30736,2013,Aug
2013-08,Texas,18131,38576,45538,1583,85697,2013,Aug
2013-08,Utah,24473,2392,3242,54,5688,2013,Aug
2013-08,Vermont,0,984,1244,30,2258,2013,Aug
2013-08,Virgin Islands,79,20,8,0,28,2013,Aug
2013-08,Virginia,0,17394,14938,742,33074,2013,Aug
2013-08,Washington,8890,13247,11664,847,25758,2013,Aug
2013-08,West Virginia,332,6037,6868,143,13048,2013,Aug
2013-08,Wisconsin,4605,10107,11966,333,22406,2013,Aug
2013-08,Wyoming,357,1736,2241,44,4021,2013,Aug
2013-07,Alabama,4632,12058,12037,381,24476,2013,Jul
2013-07,Alaska,175,2304,2659,134,5097,2013,Jul
2013-07,Arizona,8382,8425,6293,430,15148,2013,Jul
2013-07,Arkansas,11562,4027,4183,63,8273,2013,Jul
2013-07,California,38286,29531,31564,75,61170,2013,Jul
2013-07,Colorado,20021,11755,9266,514,21535,2013,Jul
2013-07,Connecticut,15391,4649,2497,53,7199,2013,Jul
2013-07,Delaware,223,1183,787,49,2019,2013,Jul
2013-07,District of Columbia,0,30,1,0,31,2013,Jul
2013-07,Florida,19829,34204,18664,1334,54202,2013,Jul
2013-07,Georgia,11798,8893,6506,231,15630,2013,Jul
2013-07,Guam,0,59,44,10,113,2013,Jul
2013-07,Hawaii,1260,0,0,0,0,2013,Jul
2013-07,Idaho,2506,1992,2898,75,4965,2013,Jul
2013-07,Illinois,55624,15986,10383,0,26369,2013,Jul
2013-07,Indiana,27949,12316,9385,481,22182,2013,Jul
2013-07,Iowa,4991,82,1603,10,1695,2013,Jul
2013-07,Kansas,4288,4830,4368,172,9370,2013,Jul
2013-07,Kentucky,12941,6395,6133,184,12712,2013,Jul
2013-07,Louisiana,0,9017,8014,386,17417,2013,Jul
2013-07,Maine,0,2244,2729,73,5046,2013,Jul
2013-07,Mariana Islands,0,0,0,0,0,2013,Jul
2013-07,Maryland,43,6533,5355,97,11985,2013,Jul
2013-07,Massachusetts,13753,4283,2289,236,6808,2013,Jul
2013-07,Michigan,14353,7378,7169,196,14743,2013,Jul
2013-07,Minnesota,15097,7020,7351,258,14629,2013,Jul
2013-07,Mississippi,622,5315,4149,102,9566,2013,Jul
2013-07,Missouri,4690,14710,10174,446,25330,2013,Jul
2013-07,Montana,1269,2393,3445,70,5908,2013,Jul
2013-07,Nebraska,2690,80,1450,14,1544,2013,Jul
2013-07,Nevada,1755,3617,2706,178,6501,2013,Jul
2013-07,New Hampshire,2721,3289,2643,35,5967,2013,Jul
2013-07,New Jersey,0,6528,3194,241,9963,2013,Jul
2013-07,New Mexico,967,4245,3514,197,7956,2013,Jul
2013-07,New York,1896,7572,9719,403,17694,2013,Jul
2013-07,North Carolina,19239,561,9607,293,10461,2013,Jul
2013-07,North Dakota,1390,1197,2267,32,3496,2013,Jul
2013-07,Ohio,0,21099,14667,772,36538,2013,Jul
2013-07,Oklahoma,0,10138,7996,473,18607,2013,Jul
2013-07,Oregon,19,8386,7441,0,15827,2013,Jul
2013-07,Pennsylvania,17521,19,43118,217,43354,2013,Jul
2013-07,Puerto Rico,0,1106,216,10,1332,2013,Jul
2013-07,Rhode Island,0,760,638,28,1426,2013,Jul
2013-07,South Carolina,10917,6074,4428,182,10684,2013,Jul
2013-07,South Dakota,0,1675,2555,64,4294,2013,Jul
2013-07,Tennessee,7609,15367,10932,0,26299,2013,Jul
2013-07,Texas,21851,35456,29941,1487,66884,2013,Jul
2013-07,Utah,23493,2157,2626,56,4839,2013,Jul
2013-07,Vermont,0,862,967,44,1873,2013,Jul
2013-07,Virgin Islands,48,24,4,0,28,2013,Jul
2013-07,Virginia,0,15759,12570,631,28960,2013,Jul
2013-07,Washington,8847,11752,9015,641,21408,2013,Jul
2013-07,West Virginia,214,5348,5169,132,10649,2013,Jul
2013-07,Wisconsin,4869,8799,7823,239,16861,2013,Jul
2013-07,Wyoming,581,1534,1694,39,3267,2013,Jul
2013-06,Alabama,1861,11054,10828,349,22231,2013,Jun
2013-06,Alaska,250,2470,2593,154,5217,2013,Jun
2013-06,Arizona,8379,8716,6413,386,15515,2013,Jun
2013-06,Arkansas,6563,3966,3974,89,8029,2013,Jun
2013-06,California,43693,29702,35007,78,64787,2013,Jun
2013-06,Colorado,9377,16137,13206,658,30001,2013,Jun
2013-06,Connecticut,14252,4545,3693,80,8318,2013,Jun
2013-06,Delaware,291,1175,862,53,2090,2013,Jun
2013-06,District of Columbia,0,25,1,0,26,2013,Jun
2013-06,Florida,17871,33559,19343,1393,54295,2013,Jun
2013-06,Georgia,9392,8591,6541,193,15325,2013,Jun
2013-06,Guam,0,44,44,3,91,2013,Jun
2013-06,Hawaii,1145,0,0,0,0,2013,Jun
2013-06,Idaho,2293,2109,3188,81,5378,2013,Jun
2013-06,Illinois,79126,15062,10196,0,25258,2013,Jun
2013-06,Indiana,15786,12447,9845,628,22920,2013,Jun
2013-06,Iowa,6450,74,1713,11,1798,2013,Jun
2013-06,Kansas,3273,4370,4246,162,8778,2013,Jun
2013-06,Kentucky,12923,6556,5943,129,12628,2013,Jun
2013-06,Louisiana,0,8734,7613,362,16709,2013,Jun
2013-06,Maine,0,2427,2712,80,5219,2013,Jun
2013-06,Mariana Islands,0,0,0,0,0,2013,Jun
2013-06,Maryland,0,6849,5318,290,12457,2013,Jun
2013-06,Massachusetts,11387,4109,2557,280,6946,2013,Jun
2013-06,Michigan,13822,7492,7573,237,15302,2013,Jun
2013-06,Minnesota,13630,7399,7387,260,15046,2013,Jun
2013-06,Mississippi,532,4744,3848,111,8703,2013,Jun
2013-06,Missouri,4416,14577,10444,465,25486,2013,Jun
2013-06,Montana,1016,2433,3569,75,6077,2013,Jun
2013-06,Nebraska,2779,91,1533,19,1643,2013,Jun
2013-06,Nevada,1938,4043,3125,196,7364,2013,Jun
2013-06,New Hampshire,2676,3514,2738,33,6285,2013,Jun
2013-06,New Jersey,0,7691,3995,418,12104,2013,Jun
2013-06,New Mexico,861,4207,3633,195,8035,2013,Jun
2013-06,New York,2451,7250,10414,453,18117,2013,Jun
2013-06,North Carolina,18140,594,9733,312,10639,2013,Jun
2013-06,North Dakota,1029,1249,2483,31,3763,2013,Jun
2013-06,Ohio,0,20896,14770,716,36382,2013,Jun
2013-06,Oklahoma,0,9454,7955,445,17854,2013,Jun
2013-06,Oregon,34,9161,8079,0,17240,2013,Jun
2013-06,Pennsylvania,16187,20,45518,266,45804,2013,Jun
2013-06,Puerto Rico,0,1320,251,9,1580,2013,Jun
2013-06,Rhode Island,0,868,657,44,1569,2013,Jun
2013-06,South Carolina,8982,6228,4220,149,10597,2013,Jun
2013-06,South Dakota,2,1761,2593,60,4414,2013,Jun
2013-06,Tennessee,10615,14513,10657,0,25170,2013,Jun
2013-06,Texas,19686,34302,30708,1566,66576,2013,Jun
2013-06,Utah,21599,2372,2814,67,5253,2013,Jun
2013-06,Vermont,0,931,975,30,1936,2013,Jun
2013-06,Virgin Islands,59,33,2,0,35,2013,Jun
2013-06,Virginia,0,16205,12574,597,29376,2013,Jun
2013-06,Washington,9316,12717,10015,817,23549,2013,Jun
2013-06,West Virginia,294,5304,5374,135,10813,2013,Jun
2013-06,Wisconsin,3535,8632,7553,336,16521,2013,Jun
2013-06,Wyoming,881,1641,1840,54,3535,2013,Jun
2013-05,Alabama,2017,13221,12165,372,25758,2013,May
2013-05,Alaska,271,2856,3569,191,6616,2013,May
2013-05,Arizona,7588,9533,7320,503,17356,2013,May
2013-05,Arkansas,5704,4865,4917,92,9874,2013,May
2013-05,California,42804,31638,37157,71,68866,2013,May
2013-05,Colorado,8990,15666,12799,654,29119,2013,May
2013-05,Connecticut,14264,4879,3459,85,8423,2013,May
2013-05,Delaware,360,1476,1017,71,2564,2013,May
2013-05,District of Columbia,0,35,5,0,40,2013,May
2013-05,Florida,27298,35935,21373,1491,58799,2013,May
2013-05,Georgia,12425,9563,7116,237,16916,2013,May
2013-05,Guam,0,58,64,9,131,2013,May
2013-05,Hawaii,1322,0,0,0,0,2013,May
2013-05,Idaho,3139,2470,3417,107,5994,2013,May
2013-05,Illinois,80948,16142,11591,0,27733,2013,May
2013-05,Indiana,14073,13497,10404,682,24583,2013,May
2013-05,Iowa,7502,78,2016,15,2109,2013,May
2013-05,Kansas,7194,5419,5179,201,10799,2013,May
2013-05,Kentucky,5897,7976,6876,161,15013,2013,May
2013-05,Louisiana,0,10087,8985,401,19473,2013,May
2013-05,Maine,0,2820,3092,85,5997,2013,May
2013-05,Mariana Islands,0,0,0,0,0,2013,May
2013-05,Maryland,1,8507,5470,146,14123,2013,May
2013-05,Massachusetts,12158,4776,2714,429,7919,2013,May
2013-05,Michigan,15804,9056,8443,283,17782,2013,May
2013-05,Minnesota,20650,9637,8787,343,18767,2013,May
2013-05,Mississippi,706,5369,4787,129,10285,2013,May
2013-05,Missouri,5972,16990,12515,625,30130,2013,May
2013-05,Montana,1455,2690,4067,111,6868,2013,May
2013-05,Nebraska,3995,83,1638,11,1732,2013,May
2013-05,Nevada,2302,4426,3571,247,8244,2013,May
2013-05,New Hampshire,4590,4051,3086,37,7174,2013,May
2013-05,New Jersey,0,7726,4486,444,12656,2013,May
2013-05,New Mexico,1588,4686,4267,196,9149,2013,May
2013-05,New York,2518,7992,11417,550,19959,2013,May
2013-05,North Carolina,22157,652,11406,380,12438,2013,May
2013-05,North Dakota,1458,1652,2856,55,4563,2013,May
2013-05,Ohio,0,23364,15596,849,39809,2013,May
2013-05,Oklahoma,0,10401,9045,506,19952,2013,May
2013-05,Oregon,23,10027,8727,0,18754,2013,May
2013-05,Pennsylvania,20864,20,49732,265,50017,2013,May
2013-05,Puerto Rico,0,1297,217,10,1524,2013,May
2013-05,Rhode Island,0,1036,819,52,1907,2013,May
2013-05,South Carolina,9441,7277,4673,218,12168,2013,May
2013-05,South Dakota,0,2180,3075,53,5308,2013,May
2013-05,Tennessee,12435,16850,12546,0,29396,2013,May
2013-05,Texas,21953,41105,34669,1948,77722,2013,May
2013-05,Utah,27875,2749,3255,96,6100,2013,May
2013-05,Vermont,0,1030,1112,46,2188,2013,May
2013-05,Virgin Islands,60,12,2,0,14,2013,May
2013-05,Virginia,0,17007,13414,687,31108,2013,May
2013-05,Washington,11878,14262,10595,797,25654,2013,May
2013-05,West Virginia,510,6371,5792,194,12357,2013,May
2013-05,Wisconsin,7046,11961,9200,385,21546,2013,May
2013-05,Wyoming,758,2066,2174,85,4325,2013,May
2013-04,Alabama,672,14930,13043,468,28441,2013,Apr
2013-04,Alaska,328,3324,4162,340,7826,2013,Apr
2013-04,Arizona,8830,11774,8650,748,21172,2013,Apr
2013-04,Arkansas,7066,5983,6145,108,12236,2013,Apr
2013-04,California,32066,34701,42516,72,77289,2013,Apr
2013-04,Colorado,6788,18548,16004,1047,35599,2013,Apr
2013-04,Connecticut,15251,6631,6531,1276,14438,2013,Apr
2013-04,Delaware,314,1871,1323,83,3277,2013,Apr
2013-04,District of Columbia,0,41,6,0,47,2013,Apr
2013-04,Florida,29479,41943,25404,2086,69433,2013,Apr
2013-04,Georgia,15918,11406,8593,288,20287,2013,Apr
2013-04,Guam,0,35,42,12,89,2013,Apr
2013-04,Hawaii,1753,0,0,0,0,2013,Apr
2013-04,Idaho,4341,3115,4476,107,7698,2013,Apr
2013-04,Illinois,98095,18421,14842,0,33263,2013,Apr
2013-04,Indiana,18389,17150,14005,787,31942,2013,Apr
2013-04,Iowa,12545,120,2947,22,3089,2013,Apr
2013-04,Kansas,5006,7408,7172,326,14906,2013,Apr
2013-04,Kentucky,15448,10079,9442,180,19701,2013,Apr
2013-04,Louisiana,0,11514,10078,445,22037,2013,Apr
2013-04,Maine,0,3940,4331,116,8387,2013,Apr
2013-04,Mariana Islands,0,0,0,0,0,2013,Apr
2013-04,Maryland,176,7924,7231,76,15231,2013,Apr
2013-04,Massachusetts,13170,5081,3717,478,9276,2013,Apr
2013-04,Michigan,22348,13166,12695,412,26273,2013,Apr
2013-04,Minnesota,23538,12801,14244,531,27576,2013,Apr
2013-04,Mississippi,836,6469,5482,170,12121,2013,Apr
2013-04,Missouri,8023,19776,16405,715,36896,2013,Apr
2013-04,Montana,1733,3411,5035,110,8556,2013,Apr
2013-04,Nebraska,5707,103,2383,21,2507,2013,Apr
2013-04,Nevada,3645,5241,4263,298,9802,2013,Apr
2013-04,New Hampshire,4899,5292,4088,67,9447,2013,Apr
2013-04,New Jersey,0,5032,3645,300,8977,2013,Apr
2013-04,New Mexico,1298,5204,5096,267,10567,2013,Apr
2013-04,New York,2706,10237,16789,514,27540,2013,Apr
2013-04,North Carolina,28195,635,13493,517,14645,2013,Apr
2013-04,North Dakota,1304,2141,3860,57,6058,2013,Apr
2013-04,Ohio,0,31627,21579,1266,54472,2013,Apr
2013-04,Oklahoma,0,13962,11874,751,26587,2013,Apr
2013-04,Oregon,40,12561,11056,0,23617,2013,Apr
2013-04,Pennsylvania,26218,22,64416,339,64777,2013,Apr
2013-04,Puerto Rico,0,1112,160,28,1300,2013,Apr
2013-04,Rhode Island,0,1256,1207,77,2540,2013,Apr
2013-04,South Carolina,10125,9032,6161,292,15485,2013,Apr
2013-04,South Dakota,2,2680,3868,78,6626,2013,Apr
2013-04,Tennessee,11113,19072,14798,0,33870,2013,Apr
2013-04,Texas,29885,48822,39216,2164,90202,2013,Apr
2013-04,Utah,22113,3690,4183,95,7968,2013,Apr
2013-04,Vermont,0,1591,1883,63,3537,2013,Apr
2013-04,Virgin Islands,85,19,4,0,23,2013,Apr
2013-04,Virginia,0,20989,17416,866,39271,2013,Apr
2013-04,Washington,15106,17008,13057,1154,31219,2013,Apr
2013-04,West Virginia,677,7548,7408,198,15154,2013,Apr
2013-04,Wisconsin,11117,14982,15166,604,30752,2013,Apr
2013-04,Wyoming,876,2254,2413,117,4784,2013,Apr
2013-03,Alabama,679,20215,18498,538,39251,2013,Mar
2013-03,Alaska,255,3506,4228,394,8128,2013,Mar
2013-03,Arizona,8288,14384,10700,729,25813,2013,Mar
2013-03,Arkansas,6472,9312,8667,141,18120,2013,Mar
2013-03,California,29750,38013,48181,80,86274,2013,Mar
2013-03,Colorado,10289,23937,20786,1258,45981,2013,Mar
2013-03,Connecticut,13901,8010,8128,1165,17303,2013,Mar
2013-03,Delaware,64,2243,1755,92,4090,2013,Mar
2013-03,District of Columbia,0,48,3,0,51,2013,Mar
2013-03,Florida,0,48586,31464,1998,82048,2013,Mar
2013-03,Georgia,19191,16404,12878,364,29646,2013,Mar
2013-03,Guam,0,31,41,7,79,2013,Mar
2013-03,Hawaii,1564,0,0,0,0,2013,Mar
2013-03,Idaho,4820,4126,5603,155,9884,2013,Mar
2013-03,Illinois,93378,23779,19564,0,43343,2013,Mar
2013-03,Indiana,12834,24239,18379,1055,43673,2013,Mar
2013-03,Iowa,14410,195,4400,33,4628,2013,Mar
2013-03,Kansas,2116,9708,9056,401,19165,2013,Mar
2013-03,Kentucky,210474,14921,12647,337,27905,2013,Mar
2013-03,Louisiana,0,14463,12844,499,27806,2013,Mar
2013-03,Maine,0,4745,4908,139,9792,2013,Mar
2013-03,Mariana Islands,0,0,0,0,0,2013,Mar
2013-03,Maryland,116,8217,8190,63,16470,2013,Mar
2013-03,Massachusetts,13484,6174,4861,496,11531,2013,Mar
2013-03,Michigan,22430,17749,16343,435,34527,2013,Mar
2013-03,Minnesota,25310,15176,14763,548,30487,2013,Mar
2013-03,Mississippi,1032,8752,8146,190,17088,2013,Mar
2013-03,Missouri,9608,26501,21600,945,49046,2013,Mar
2013-03,Montana,2058,4358,5536,122,10016,2013,Mar
2013-03,Nebraska,7750,134,3020,23,3177,2013,Mar
2013-03,Nevada,2966,6305,5169,308,11782,2013,Mar
2013-03,New Hampshire,4269,6519,5004,66,11589,2013,Mar
2013-03,New Jersey,0,5369,4219,255,9843,2013,Mar
2013-03,New Mexico,1620,6870,6126,313,13309,2013,Mar
2013-03,New York,2800,12598,18458,605,31661,2013,Mar
2013-03,North Carolina,32790,936,19162,627,20725,2013,Mar
2013-03,North Dakota,1103,2735,3882,93,6710,2013,Mar
2013-03,Ohio,0,42641,27725,1614,71980,2013,Mar
2013-03,Oklahoma,0,17319,14650,720,32689,2013,Mar
2013-03,Oregon,115,14859,13047,0,27906,2013,Mar
2013-03,Pennsylvania,29573,43,84244,349,84636,2013,Mar
2013-03,Puerto Rico,0,1001,194,10,1205,2013,Mar
2013-03,Rhode Island,0,1546,1224,53,2823,2013,Mar
2013-03,South Carolina,10645,12620,9103,375,22098,2013,Mar
2013-03,South Dakota,7,3537,5315,94,8946,2013,Mar
2013-03,Tennessee,12700,26152,21626,0,47778,2013,Mar
2013-03,Texas,32693,64439,49206,2553,116198,2013,Mar
2013-03,Utah,20526,5415,5409,121,10945,2013,Mar
2013-03,Vermont,0,1899,2044,59,4002,2013,Mar
2013-03,Virgin Islands,253,9,8,0,17,2013,Mar
2013-03,Virginia,0,28321,22841,1122,52284,2013,Mar
2013-03,Washington,19337,21189,15283,1303,37775,2013,Mar
2013-03,West Virginia,665,10984,10380,295,21659,2013,Mar
2013-03,Wisconsin,12264,18924,18367,557,37848,2013,Mar
2013-03,Wyoming,787,3110,2998,118,6226,2013,Mar
2013-02,Alabama,738,24166,19763,579,44508,2013,Feb
2013-02,Alaska,179,4011,4073,355,8439,2013,Feb
2013-02,Arizona,5861,16313,11166,580,28059,2013,Feb
2013-02,Arkansas,4559,12200,10228,144,22572,2013,Feb
2013-02,California,23358,38087,46026,97,84210,2013,Feb
2013-02,Colorado,3582,27732,20546,1080,49358,2013,Feb
2013-02,Connecticut,10461,6813,6190,652,13655,2013,Feb
2013-02,Delaware,15,2358,1658,99,4115,2013,Feb
2013-02,District of Columbia,0,58,3,0,61,2013,Feb
2013-02,Florida,0,56967,34711,1948,93626,2013,Feb
2013-02,Georgia,23389,22516,14256,363,37135,2013,Feb
2013-02,Guam,0,53,38,2,93,2013,Feb
2013-02,Hawaii,1803,0,0,0,0,2013,Feb
2013-02,Idaho,5180,5043,5712,128,10883,2013,Feb
2013-02,Illinois,83806,24175,18387,0,42562,2013,Feb
2013-02,Indiana,10011,26643,18179,865,45687,2013,Feb
2013-02,Iowa,15868,238,3995,34,4267,2013,Feb
2013-02,Kansas,1787,11355,9238,320,20913,2013,Feb
2013-02,Kentucky,205714,19072,13980,321,33373,2013,Feb
2013-02,Louisiana,0,16804,13560,582,30946,2013,Feb
2013-02,Maine,0,4228,4097,109,8434,2013,Feb
2013-02,Mariana Islands,0,0,2,0,2,2013,Feb
2013-02,Maryland,8,7965,7786,76,15827,2013,Feb
2013-02,Massachusetts,11361,5818,3578,513,9909,2013,Feb
2013-02,Michigan,20254,18279,14848,448,33575,2013,Feb
2013-02,Minnesota,24632,15779,12716,549,29044,2013,Feb
2013-02,Mississippi,1135,11204,9433,238,20875,2013,Feb
2013-02,Missouri,6591,30172,21984,830,52986,2013,Feb
2013-02,Montana,1997,4766,5232,116,10114,2013,Feb
2013-02,Nebraska,6567,160,2993,34,3187,2013,Feb
2013-02,Nevada,2771,7432,5095,538,13065,2013,Feb
2013-02,New Hampshire,4234,6214,4434,75,10723,2013,Feb
2013-02,New Jersey,0,4472,4274,226,8972,2013,Feb
2013-02,New Mexico,1138,7396,6328,290,14014,2013,Feb
2013-02,New York,2486,11469,17235,523,29227,2013,Feb
2013-02,North Carolina,41227,1085,21728,691,23504,2013,Feb
2013-02,North Dakota,979,3143,3764,56,6963,2013,Feb
2013-02,Ohio,0,45622,26931,1624,74177,2013,Feb
2013-02,Oklahoma,0,20619,15693,673,36985,2013,Feb
2013-02,Oregon,71,16691,13428,0,30119,2013,Feb
2013-02,Pennsylvania,31277,26,82258,278,82562,2013,Feb
2013-02,Puerto Rico,0,1006,214,21,1241,2013,Feb
2013-02,Rhode Island,0,1343,992,43,2378,2013,Feb
2013-02,South Carolina,11168,16733,9776,444,26953,2013,Feb
2013-02,South Dakota,0,4160,5054,120,9334,2013,Feb
2013-02,Tennessee,13110,32630,23703,0,56333,2013,Feb
2013-02,Texas,37366,76087,52208,2437,130732,2013,Feb
2013-02,Utah,15194,6512,5464,154,12130,2013,Feb
2013-02,Vermont,0,2140,1961,49,4150,2013,Feb
2013-02,Virgin Islands,0,5,1,0,6,2013,Feb
2013-02,Virginia,0,32229,23554,1341,57124,2013,Feb
2013-02,Washington,19602,24333,16360,1208,41901,2013,Feb
2013-02,West Virginia,749,12345,10340,264,22949,2013,Feb
2013-02,Wisconsin,13396,20921,15247,496,36664,2013,Feb
2013-02,Wyoming,628,3284,2803,96,6183,2013,Feb
2013-01,Alabama,848,26630,22168,645,49443,2013,Jan
2013-01,Alaska,116,4765,4255,215,9235,2013,Jan
2013-01,Arizona,4954,19373,13109,859,33341,2013,Jan
2013-01,Arkansas,4714,11566,9868,204,21638,2013,Jan
2013-01,California,26591,51025,54527,96,105648,2013,Jan
2013-01,Colorado,3324,26419,19972,761,47152,2013,Jan
2013-01,Connecticut,13192,9275,8636,757,18668,2013,Jan
2013-01,Delaware,10,2902,1909,109,4920,2013,Jan
2013-01,District of Columbia,0,55,4,0,59,2013,Jan
2013-01,Florida,0,68294,41844,2047,112185,2013,Jan
2013-01,Georgia,27940,23439,14798,383,38620,2013,Jan
2013-01,Guam,0,67,54,6,127,2013,Jan
2013-01,Hawaii,2260,0,0,0,0,2013,Jan
2013-01,Idaho,4925,5676,5792,165,11633,2013,Jan
2013-01,Illinois,94721,31185,22138,0,53323,2013,Jan
2013-01,Indiana,8353,30334,20505,1121,51960,2013,Jan
2013-01,Iowa,19235,344,4399,68,4811,2013,Jan
2013-01,Kansas,2298,13924,10878,488,25290,2013,Jan
2013-01,Kentucky,203214,17460,13023,448,30931,2013,Jan
2013-01,Louisiana,0,21046,17511,799,39356,2013,Jan
2013-01,Maine,0,5306,4566,173,10045,2013,Jan
2013-01,Mariana Islands,0,0,1,0,1,2013,Jan
2013-01,Maryland,0,9416,8660,76,18152,2013,Jan
2013-01,Massachusetts,15008,7295,4810,409,12514,2013,Jan
2013-01,Michigan,22567,21547,15621,402,37570,2013,Jan
2013-01,Minnesota,30700,17763,13846,650,32259,2013,Jan
2013-01,Mississippi,896,11296,10927,315,22538,2013,Jan
2013-01,Missouri,6121,36400,24147,1077,61624,2013,Jan
2013-01,Montana,2663,5509,5273,130,10912,2013,Jan
2013-01,Nebraska,10876,201,3519,35,3755,2013,Jan
2013-01,Nevada,2578,8354,5865,416,14635,2013,Jan
2013-01,New Hampshire,6362,7968,6068,96,14132,2013,Jan
2013-01,New Jersey,0,4958,5888,264,11110,2013,Jan
2013-01,New Mexico,860,7683,6624,321,14628,2013,Jan
2013-01,New York,2935,13448,25744,1143,40335,2013,Jan
2013-01,North Carolina,42040,1282,22157,755,24194,2013,Jan
2013-01,North Dakota,1173,3893,4222,59,8174,2013,Jan
2013-01,Ohio,0,49243,29034,1625,79902,2013,Jan
2013-01,Oklahoma,0,24793,17756,922,43471,2013,Jan
2013-01,Oregon,66,19225,14044,0,33269,2013,Jan
2013-01,Pennsylvania,41617,61,93619,304,93984,2013,Jan
2013-01,Puerto Rico,0,1092,221,16,1329,2013,Jan
2013-01,Rhode Island,0,1831,1555,41,3427,2013,Jan
2013-01,South Carolina,9893,15015,8903,662,24580,2013,Jan
2013-01,South Dakota,0,5023,5512,139,10674,2013,Jan
2013-01,Tennessee,9601,34623,23963,0,58586,2013,Jan
2013-01,Texas,19093,89130,60897,3015,153042,2013,Jan
2013-01,Utah,12829,8344,5834,161,14339,2013,Jan
2013-01,Vermont,0,2203,1810,72,4085,2013,Jan
2013-01,Virgin Islands,0,17,8,0,25,2013,Jan
2013-01,Virginia,0,34636,24775,1426,60837,2013,Jan
2013-01,Washington,22087,28505,18241,1252,47998,2013,Jan
2013-01,West Virginia,615,12197,10377,318,22892,2013,Jan
2013-01,Wisconsin,15439,25154,15454,593,41201,2013,Jan
2013-01,Wyoming,362,3848,2997,99,6944,2013,Jan
2012-12,Alabama,777,30614,42433,777,73824,2012,Dec
2012-12,Alaska,0,5179,6304,268,11751,2012,Dec
2012-12,Arizona,4074,20512,19634,1142,41288,2012,Dec
2012-12,Arkansas,3757,11711,19680,246,31637,2012,Dec
2012-12,California,25144,51731,73026,91,124848,2012,Dec
2012-12,Colorado,2399,23511,24846,820,49177,2012,Dec
2012-12,Connecticut,10403,8845,9274,712,18831,2012,Dec
2012-12,Delaware,7,2621,2747,120,5488,2012,Dec
2012-12,District of Columbia,0,50,1,0,51,2012,Dec
2012-12,Florida,0,65872,59904,2549,128325,2012,Dec
2012-12,Georgia,14710,26035,32774,472,59281,2012,Dec
2012-12,Guam,0,49,55,3,107,2012,Dec
2012-12,Hawaii,2014,0,0,0,0,2012,Dec
2012-12,Idaho,2423,6555,10015,248,16818,2012,Dec
2012-12,Illinois,53218,28548,28820,0,57368,2012,Dec
2012-12,Indiana,7578,28474,31940,1357,61771,2012,Dec
2012-12,Iowa,10863,235,8121,53,8409,2012,Dec
2012-12,Kansas,1587,13854,17592,537,31983,2012,Dec
2012-12,Kentucky,208969,19442,26550,433,46425,2012,Dec
2012-12,Louisiana,0,21599,33919,765,56283,2012,Dec
2012-12,Maine,0,4916,6755,239,11910,2012,Dec
2012-12,Mariana Islands,0,0,0,0,0,2012,Dec
2012-12,Maryland,4,7827,11046,57,18930,2012,Dec
2012-12,Massachusetts,11343,7200,5746,557,13503,2012,Dec
2012-12,Michigan,24411,7170,26867,492,34529,2012,Dec
2012-12,Minnesota,20683,13840,19260,824,33924,2012,Dec
2012-12,Mississippi,367,12616,25190,497,38303,2012,Dec
2012-12,Missouri,3425,35516,36872,1448,73836,2012,Dec
2012-12,Montana,1285,6287,8919,187,15393,2012,Dec
2012-12,Nebraska,8300,224,6715,30,6969,2012,Dec
2012-12,Nevada,2053,9274,9429,450,19153,2012,Dec
2012-12,New Hampshire,3722,8412,7366,135,15913,2012,Dec
2012-12,New Jersey,0,3825,5947,275,10047,2012,Dec
2012-12,New Mexico,607,8477,10310,428,19215,2012,Dec
2012-12,New York,2317,9489,34876,1212,45577,2012,Dec
2012-12,North Carolina,25445,1234,41758,773,43765,2012,Dec
2012-12,North Dakota,650,3551,6324,71,9946,2012,Dec
2012-12,Ohio,0,48667,47197,2002,97866,2012,Dec
2012-12,Oklahoma,0,25216,29041,1171,55428,2012,Dec
2012-12,Oregon,81,21566,22599,0,44165,2012,Dec
2012-12,Pennsylvania,27017,78,105826,319,106223,2012,Dec
2012-12,Puerto Rico,0,1458,262,23,1743,2012,Dec
2012-12,Rhode Island,0,1631,1865,40,3536,2012,Dec
2012-12,South Carolina,4575,16842,18436,661,35939,2012,Dec
2012-12,South Dakota,0,5079,8910,120,14109,2012,Dec
2012-12,Tennessee,8429,37951,43721,0,81672,2012,Dec
2012-12,Texas,12389,98886,108058,3699,210643,2012,Dec
2012-12,Utah,9722,9885,12126,234,22245,2012,Dec
2012-12,Vermont,0,2001,2622,92,4715,2012,Dec
2012-12,Virgin Islands,0,20,6,0,26,2012,Dec
2012-12,Virginia,0,36554,39104,1829,77487,2012,Dec
2012-12,Washington,13496,27035,28335,2004,57374,2012,Dec
2012-12,West Virginia,271,12009,18169,335,30513,2012,Dec
2012-12,Wisconsin,9627,22343,22451,803,45597,2012,Dec
2012-12,Wyoming,232,4157,4722,117,8996,2012,Dec
2012-11,Alabama,435,17207,27326,518,45051,2012,Nov
2012-11,Alaska,1,3136,4182,250,7568,2012,Nov
2012-11,Arizona,4477,12968,12975,587,26530,2012,Nov
2012-11,Arkansas,3361,6340,14554,145,21039,2012,Nov
2012-11,California,27231,35855,49929,74,85858,2012,Nov
2012-11,Colorado,3007,19733,21463,633,41829,2012,Nov
2012-11,Connecticut,9823,5819,6571,324,12714,2012,Nov
2012-11,Delaware,13,1544,1989,60,3593,2012,Nov
2012-11,District of Columbia,0,37,3,0,40,2012,Nov
2012-11,Florida,0,43550,37856,1653,83059,2012,Nov
2012-11,Georgia,9246,13482,19167,295,32944,2012,Nov
2012-11,Guam,0,35,39,4,78,2012,Nov
2012-11,Hawaii,1622,0,0,0,0,2012,Nov
2012-11,Idaho,2017,3360,6640,137,10137,2012,Nov
2012-11,Illinois,51530,16845,22364,0,39209,2012,Nov
2012-11,Indiana,4124,17383,24331,899,42613,2012,Nov
2012-11,Iowa,8611,157,7217,24,7398,2012,Nov
2012-11,Kansas,1458,8330,12794,376,21500,2012,Nov
2012-11,Kentucky,185005,10571,17789,255,28615,2012,Nov
2012-11,Louisiana,0,11882,22676,499,35057,2012,Nov
2012-11,Maine,0,3024,5425,128,8577,2012,Nov
2012-11,Mariana Islands,0,0,0,0,0,2012,Nov
2012-11,Maryland,2,7141,9488,33,16662,2012,Nov
2012-11,Massachusetts,11588,4870,4149,350,9369,2012,Nov
2012-11,Michigan,20493,1453,22403,286,24142,2012,Nov
2012-11,Minnesota,14262,8820,15392,418,24630,2012,Nov
2012-11,Mississippi,289,6880,18507,293,25680,2012,Nov
2012-11,Missouri,3042,19943,27029,827,47799,2012,Nov
2012-11,Montana,831,3127,5926,91,9144,2012,Nov
2012-11,Nebraska,4950,128,5162,29,5319,2012,Nov
2012-11,Nevada,1625,5795,5961,268,12024,2012,Nov
2012-11,New Hampshire,2472,4740,4934,45,9719,2012,Nov
2012-11,New Jersey,0,3647,5013,250,8910,2012,Nov
2012-11,New Mexico,840,5038,6492,237,11767,2012,Nov
2012-11,New York,2315,6692,28126,696,35514,2012,Nov
2012-11,North Carolina,19178,798,27342,530,28670,2012,Nov
2012-11,North Dakota,683,1704,4810,60,6574,2012,Nov
2012-11,Ohio,0,32230,36389,1108,69727,2012,Nov
2012-11,Oklahoma,0,16850,20102,822,37774,2012,Nov
2012-11,Oregon,33,12059,15041,0,27100,2012,Nov
2012-11,Pennsylvania,21226,50,78231,322,78603,2012,Nov
2012-11,Puerto Rico,0,1063,172,14,1249,2012,Nov
2012-11,Rhode Island,0,1028,1224,24,2276,2012,Nov
2012-11,South Carolina,4895,10098,12015,289,22402,2012,Nov
2012-11,South Dakota,0,2663,6767,74,9504,2012,Nov
2012-11,Tennessee,8182,22221,28279,0,50500,2012,Nov
2012-11,Texas,13692,52840,64903,2231,119974,2012,Nov
2012-11,Utah,10641,4720,7559,121,12400,2012,Nov
2012-11,Vermont,0,1096,1994,36,3126,2012,Nov
2012-11,Virgin Islands,0,15,7,1,23,2012,Nov
2012-11,Virginia,0,22826,28382,1208,52416,2012,Nov
2012-11,Washington,10661,17319,18004,1106,36429,2012,Nov
2012-11,West Virginia,270,6753,14321,197,21271,2012,Nov
2012-11,Wisconsin,8089,14976,20715,474,36165,2012,Nov
2012-11,Wyoming,306,2360,3136,85,5581,2012,Nov
2012-10,Alabama,511,12104,14698,370,27172,2012,Oct
2012-10,Alaska,2,3453,4010,207,7670,2012,Oct
2012-10,Arizona,3982,9272,7918,423,17613,2012,Oct
2012-10,Arkansas,4177,4520,9560,111,14191,2012,Oct
2012-10,California,29124,28860,30305,54,59219,2012,Oct
2012-10,Colorado,4225,14356,15055,419,29830,2012,Oct
2012-10,Connecticut,9006,4725,4865,158,9748,2012,Oct
2012-10,Delaware,16,1171,1235,41,2447,2012,Oct
2012-10,District of Columbia,0,50,3,0,53,2012,Oct
2012-10,Florida,0,35686,23640,1071,60397,2012,Oct
2012-10,Georgia,10188,9597,12258,191,22046,2012,Oct
2012-10,Guam,0,34,42,4,80,2012,Oct
2012-10,Hawaii,1569,0,0,0,0,2012,Oct
2012-10,Idaho,2285,2226,5153,71,7450,2012,Oct
2012-10,Illinois,49184,13118,15029,0,28147,2012,Oct
2012-10,Indiana,6449,14083,15844,690,30617,2012,Oct
2012-10,Iowa,7158,128,4538,33,4699,2012,Oct
2012-10,Kansas,1522,5721,7612,209,13542,2012,Oct
2012-10,Kentucky,195917,8226,11474,154,19854,2012,Oct
2012-10,Louisiana,0,9056,16181,352,25589,2012,Oct
2012-10,Maine,0,2684,6431,72,9187,2012,Oct
2012-10,Mariana Islands,0,0,1,0,1,2012,Oct
2012-10,Maryland,5,5491,5835,29,11355,2012,Oct
2012-10,Massachusetts,10918,4609,3111,256,7976,2012,Oct
2012-10,Michigan,19781,1313,15585,243,17141,2012,Oct
2012-10,Minnesota,13056,7752,20598,315,28665,2012,Oct
2012-10,Mississippi,405,4859,10027,164,15050,2012,Oct
2012-10,Missouri,3674,15628,20116,634,36378,2012,Oct
2012-10,Montana,1007,2662,6824,58,9544,2012,Oct
2012-10,Nebraska,4007,88,3579,15,3682,2012,Oct
2012-10,Nevada,1877,4404,3703,178,8285,2012,Oct
2012-10,New Hampshire,2737,3740,4058,37,7835,2012,Oct
2012-10,New Jersey,0,3393,3228,170,6791,2012,Oct
2012-10,New Mexico,1144,4238,4644,160,9042,2012,Oct
2012-10,New York,1689,6546,21226,540,28312,2012,Oct
2012-10,North Carolina,18364,788,16214,353,17355,2012,Oct
2012-10,North Dakota,928,1559,6165,40,7764,2012,Oct
2012-10,Ohio,0,23729,21397,816,45942,2012,Oct
2012-10,Oklahoma,0,10986,12235,475,23696,2012,Oct
2012-10,Oregon,36,9513,10440,0,19953,2012,Oct
2012-10,Pennsylvania,21475,29,58116,201,58346,2012,Oct
2012-10,Puerto Rico,0,1126,176,3,1305,2012,Oct
2012-10,Rhode Island,0,879,853,20,1752,2012,Oct
2012-10,South Carolina,5573,7498,7606,223,15327,2012,Oct
2012-10,South Dakota,0,2144,7113,47,9304,2012,Oct
2012-10,Tennessee,5467,16835,16902,0,33737,2012,Oct
2012-10,Texas,13933,37556,44643,1584,83783,2012,Oct
2012-10,Utah,12489,2418,4257,56,6731,2012,Oct
2012-10,Vermont,0,1061,2033,18,3112,2012,Oct
2012-10,Virgin Islands,0,26,8,1,35,2012,Oct
2012-10,Virginia,0,16759,17809,774,35342,2012,Oct
2012-10,Washington,11762,13645,13258,747,27650,2012,Oct
2012-10,West Virginia,229,5692,9496,148,15336,2012,Oct
2012-10,Wisconsin,9519,12674,18015,354,31043,2012,Oct
2012-10,Wyoming,359,1550,2439,49,4038,2012,Oct
2012-09,Alabama,421,10831,12511,318,23660,2012,Sep
2012-09,Alaska,3,2338,3131,94,5563,2012,Sep
2012-09,Arizona,5147,9685,7771,364,17820,2012,Sep
2012-09,Arkansas,3799,4717,7672,108,12497,2012,Sep
2012-09,California,22200,26752,29344,52,56148,2012,Sep
2012-09,Colorado,3437,13865,13590,370,27825,2012,Sep
2012-09,Connecticut,8264,4440,4025,170,8635,2012,Sep
2012-09,Delaware,0,1097,973,33,2103,2012,Sep
2012-09,District of Columbia,0,28,1,0,29,2012,Sep
2012-09,Florida,0,33996,20479,895,55370,2012,Sep
2012-09,Georgia,8164,9188,9206,197,18591,2012,Sep
2012-09,Guam,0,30,33,3,66,2012,Sep
2012-09,Hawaii,1334,0,0,0,0,2012,Sep
2012-09,Idaho,1779,2439,4728,77,7244,2012,Sep
2012-09,Illinois,45837,11788,12727,0,24515,2012,Sep
2012-09,Indiana,5584,12916,12873,509,26298,2012,Sep
2012-09,Iowa,5352,81,3379,18,3478,2012,Sep
2012-09,Kansas,1095,5147,6172,201,11520,2012,Sep
2012-09,Kentucky,194898,7850,9397,155,17402,2012,Sep
2012-09,Louisiana,0,11017,16304,359,27680,2012,Sep
2012-09,Maine,0,2838,5155,96,8089,2012,Sep
2012-09,Mariana Islands,0,0,0,0,0,2012,Sep
2012-09,Maryland,0,4569,4704,25,9298,2012,Sep
2012-09,Massachusetts,10529,4108,2536,198,6842,2012,Sep
2012-09,Michigan,16637,1039,14424,194,15657,2012,Sep
2012-09,Minnesota,12011,7119,16723,277,24119,2012,Sep
2012-09,Mississippi,366,4532,7018,146,11696,2012,Sep
2012-09,Missouri,2898,15282,15154,498,30934,2012,Sep
2012-09,Montana,752,2673,5512,71,8256,2012,Sep
2012-09,Nebraska,3095,80,2506,9,2595,2012,Sep
2012-09,Nevada,1034,4325,3638,192,8155,2012,Sep
2012-09,New Hampshire,2370,3837,3776,31,7644,2012,Sep
2012-09,New Jersey,0,3487,2801,183,6471,2012,Sep
2012-09,New Mexico,436,4034,4265,161,8460,2012,Sep
2012-09,New York,2185,5784,19289,564,25637,2012,Sep
2012-09,North Carolina,15111,662,13039,261,13962,2012,Sep
2012-09,North Dakota,619,1435,4176,35,5646,2012,Sep
2012-09,Ohio,0,22700,18049,649,41398,2012,Sep
2012-09,Oklahoma,0,10048,10635,430,21113,2012,Sep
2012-09,Oregon,44,9240,10918,0,20158,2012,Sep
2012-09,Pennsylvania,18775,27,53559,203,53789,2012,Sep
2012-09,Puerto Rico,0,931,186,9,1126,2012,Sep
2012-09,Rhode Island,0,821,791,20,1632,2012,Sep
2012-09,South Carolina,5529,6784,6071,190,13045,2012,Sep
2012-09,South Dakota,0,2033,4472,49,6554,2012,Sep
2012-09,Tennessee,4956,15153,14344,0,29497,2012,Sep
2012-09,Texas,11425,36471,45464,1454,83389,2012,Sep
2012-09,Utah,9595,2559,3815,47,6421,2012,Sep
2012-09,Vermont,0,1128,1774,25,2927,2012,Sep
2012-09,Virgin Islands,0,34,6,1,41,2012,Sep
2012-09,Virginia,0,17365,15658,726,33749,2012,Sep
2012-09,Washington,9647,12209,11217,526,23952,2012,Sep
2012-09,West Virginia,308,5746,8041,135,13922,2012,Sep
2012-09,Wisconsin,7616,11137,14610,303,26050,2012,Sep
2012-09,Wyoming,226,1599,2408,35,4042,2012,Sep
2012-08,Alabama,542,13805,12264,386,26455,2012,Aug
2012-08,Alaska,60,2881,3703,115,6699,2012,Aug
2012-08,Arizona,5656,10858,8157,420,19435,2012,Aug
2012-08,Arkansas,2711,4935,6330,92,11357,2012,Aug
2012-08,California,25118,29494,31911,63,61468,2012,Aug
2012-08,Colorado,3563,15970,13345,430,29745,2012,Aug
2012-08,Connecticut,9722,4776,3816,171,8763,2012,Aug
2012-08,Delaware,0,1198,980,33,2211,2012,Aug
2012-08,District of Columbia,0,37,3,0,40,2012,Aug
2012-08,Florida,0,37184,20301,1162,58647,2012,Aug
2012-08,Georgia,9914,10610,9326,189,20125,2012,Aug
2012-08,Guam,0,39,36,1,76,2012,Aug
2012-08,Hawaii,1426,0,0,0,0,2012,Aug
2012-08,Idaho,2157,2571,4123,71,6765,2012,Aug
2012-08,Illinois,57937,12980,14054,0,27034,2012,Aug
2012-08,Indiana,7534,13991,12638,593,27222,2012,Aug
2012-08,Iowa,6876,82,2810,14,2906,2012,Aug
2012-08,Kansas,1582,5923,6423,241,12587,2012,Aug
2012-08,Kentucky,193694,8244,8463,170,16877,2012,Aug
2012-08,Louisiana,0,9985,11956,346,22287,2012,Aug
2012-08,Maine,0,2833,3623,83,6539,2012,Aug
2012-08,Mariana Islands,0,0,0,0,0,2012,Aug
2012-08,Maryland,85,5534,4683,44,10261,2012,Aug
2012-08,Massachusetts,10178,4616,2689,177,7482,2012,Aug
2012-08,Michigan,19047,1179,11769,210,13158,2012,Aug
2012-08,Minnesota,13106,7738,12588,253,20579,2012,Aug
2012-08,Mississippi,545,5764,7545,158,13467,2012,Aug
2012-08,Missouri,3078,16799,15229,546,32574,2012,Aug
2012-08,Montana,959,3047,4567,57,7671,2012,Aug
2012-08,Nebraska,3574,91,2335,10,2436,2012,Aug
2012-08,Nevada,1958,4693,3576,174,8443,2012,Aug
2012-08,New Hampshire,2834,3890,3151,27,7068,2012,Aug
2012-08,New Jersey,0,3918,3039,222,7179,2012,Aug
2012-08,New Mexico,709,4661,4097,187,8945,2012,Aug
2012-08,New York,2784,6177,14572,462,21211,2012,Aug
2012-08,North Carolina,17510,663,13545,346,14554,2012,Aug
2012-08,North Dakota,650,1532,3269,32,4833,2012,Aug
2012-08,Ohio,0,23175,16601,763,40539,2012,Aug
2012-08,Oklahoma,0,12054,10903,502,23459,2012,Aug
2012-08,Oregon,14,9485,8795,0,18280,2012,Aug
2012-08,Pennsylvania,3014,44,72106,10,72160,2012,Aug
2012-08,Puerto Rico,0,1053,285,3,1341,2012,Aug
2012-08,Rhode Island,0,771,744,13,1528,2012,Aug
2012-08,South Carolina,6624,7592,6331,155,14078,2012,Aug
2012-08,South Dakota,0,2131,3794,59,5984,2012,Aug
2012-08,Tennessee,5372,17328,15654,0,32982,2012,Aug
2012-08,Texas,16917,40131,44238,1693,86062,2012,Aug
2012-08,Utah,12767,2746,3221,46,6013,2012,Aug
2012-08,Vermont,0,1073,1258,21,2352,2012,Aug
2012-08,Virgin Islands,0,31,7,0,38,2012,Aug
2012-08,Virginia,0,17146,14148,745,32039,2012,Aug
2012-08,Washington,10860,13652,10437,661,24750,2012,Aug
2012-08,West Virginia,89,6099,6846,152,13097,2012,Aug
2012-08,Wisconsin,10198,11551,11991,311,23853,2012,Aug
2012-08,Wyoming,408,1813,2131,43,3987,2012,Aug
2012-07,Alabama,476,12182,9921,296,22399,2012,Jul
2012-07,Alaska,23,2555,2737,84,5376,2012,Jul
2012-07,Arizona,5238,9696,6340,342,16378,2012,Jul
2012-07,Arkansas,2809,4346,4738,87,9171,2012,Jul
2012-07,California,26121,26313,27530,52,53895,2012,Jul
2012-07,Colorado,3506,13433,10672,315,24420,2012,Jul
2012-07,Connecticut,9371,4099,2942,120,7161,2012,Jul
2012-07,Delaware,0,1031,802,37,1870,2012,Jul
2012-07,District of Columbia,0,41,0,0,41,2012,Jul
2012-07,Florida,0,34543,17864,926,53333,2012,Jul
2012-07,Georgia,8928,9216,6776,173,16165,2012,Jul
2012-07,Guam,0,32,27,1,60,2012,Jul
2012-07,Hawaii,1313,0,0,0,0,2012,Jul
2012-07,Idaho,2060,2052,2972,58,5082,2012,Jul
2012-07,Illinois,43809,11401,9755,0,21156,2012,Jul
2012-07,Indiana,6499,11809,9380,387,21576,2012,Jul
2012-07,Iowa,6372,73,2036,16,2125,2012,Jul
2012-07,Kansas,2066,5192,4622,178,9992,2012,Jul
2012-07,Kentucky,191827,7523,6566,128,14217,2012,Jul
2012-07,Louisiana,0,8963,8184,261,17408,2012,Jul
2012-07,Maine,0,2231,2681,71,4983,2012,Jul
2012-07,Mariana Islands,0,0,0,0,0,2012,Jul
2012-07,Maryland,1,4558,3668,38,8264,2012,Jul
2012-07,Massachusetts,8695,3734,1973,132,5839,2012,Jul
2012-07,Michigan,16257,1026,8053,141,9220,2012,Jul
2012-07,Minnesota,10550,6424,7588,230,14242,2012,Jul
2012-07,Mississippi,480,4557,4712,113,9382,2012,Jul
2012-07,Missouri,2804,13903,10796,431,25130,2012,Jul
2012-07,Montana,990,2532,3400,46,5978,2012,Jul
2012-07,Nebraska,2771,73,1595,12,1680,2012,Jul
2012-07,Nevada,1170,4086,3108,148,7342,2012,Jul
2012-07,New Hampshire,2317,3350,2598,20,5968,2012,Jul
2012-07,New Jersey,0,3759,2504,167,6430,2012,Jul
2012-07,New Mexico,547,3853,3378,123,7354,2012,Jul
2012-07,New York,2166,6002,11448,372,17822,2012,Jul
2012-07,North Carolina,15805,653,9311,234,10198,2012,Jul
2012-07,North Dakota,1053,1273,2344,24,3641,2012,Jul
2012-07,Ohio,0,20677,13904,581,35162,2012,Jul
2012-07,Oklahoma,0,10487,7960,378,18825,2012,Jul
2012-07,Oregon,11,8707,7660,0,16367,2012,Jul
2012-07,Pennsylvania,319,40,63868,0,63908,2012,Jul
2012-07,Puerto Rico,0,962,208,3,1173,2012,Jul
2012-07,Rhode Island,0,763,622,17,1402,2012,Jul
2012-07,South Carolina,9130,6315,4318,138,10771,2012,Jul
2012-07,South Dakota,0,1693,2627,34,4354,2012,Jul
2012-07,Tennessee,7955,15308,11123,0,26431,2012,Jul
2012-07,Texas,14657,35783,29918,1315,67016,2012,Jul
2012-07,Utah,10831,2227,2623,35,4885,2012,Jul
2012-07,Vermont,0,985,1019,31,2035,2012,Jul
2012-07,Virgin Islands,0,25,8,0,33,2012,Jul
2012-07,Virginia,0,17361,12028,675,30064,2012,Jul
2012-07,Washington,9529,12532,9007,584,22123,2012,Jul
2012-07,West Virginia,235,4976,4724,117,9817,2012,Jul
2012-07,Wisconsin,7218,10575,7702,217,18494,2012,Jul
2012-07,Wyoming,321,1413,1653,36,3102,2012,Jul
2012-06,Alabama,414,11540,9390,256,21186,2012,Jun
2012-06,Alaska,0,2783,2756,90,5629,2012,Jun
2012-06,Arizona,5808,8893,6121,331,15345,2012,Jun
2012-06,Arkansas,1939,4158,4241,63,8462,2012,Jun
2012-06,California,30722,26514,27427,87,54028,2012,Jun
2012-06,Colorado,2561,11986,10435,290,22711,2012,Jun
2012-06,Connecticut,9575,4452,3178,135,7765,2012,Jun
2012-06,Delaware,0,925,748,21,1694,2012,Jun
2012-06,District of Columbia,0,18,2,0,20,2012,Jun
2012-06,Florida,0,33679,17828,725,52232,2012,Jun
2012-06,Georgia,7298,9085,6591,154,15830,2012,Jun
2012-06,Guam,0,43,33,5,81,2012,Jun
2012-06,Hawaii,1260,0,0,0,0,2012,Jun
2012-06,Idaho,1985,2280,3426,53,5759,2012,Jun
2012-06,Illinois,52870,11820,10114,0,21934,2012,Jun
2012-06,Indiana,4834,12193,9656,432,22281,2012,Jun
2012-06,Iowa,5136,72,2177,17,2266,2012,Jun
2012-06,Kansas,1588,4655,4532,134,9321,2012,Jun
2012-06,Kentucky,190681,7304,6699,122,14125,2012,Jun
2012-06,Louisiana,0,8801,7345,266,16412,2012,Jun
2012-06,Maine,0,2420,2710,63,5193,2012,Jun
2012-06,Mariana Islands,0,0,1,0,1,2012,Jun
2012-06,Maryland,0,4118,3729,37,7884,2012,Jun
2012-06,Massachusetts,8784,3896,2244,125,6265,2012,Jun
2012-06,Michigan,16666,1083,7942,173,9198,2012,Jun
2012-06,Minnesota,12162,6576,7472,197,14245,2012,Jun
2012-06,Mississippi,350,4542,4153,96,8791,2012,Jun
2012-06,Missouri,2889,14002,10593,390,24985,2012,Jun
2012-06,Montana,933,2878,3956,64,6898,2012,Jun
2012-06,Nebraska,2496,70,1749,10,1829,2012,Jun
2012-06,Nevada,1251,4141,3310,161,7612,2012,Jun
2012-06,New Hampshire,3636,3132,2691,17,5840,2012,Jun
2012-06,New Jersey,0,4070,2484,169,6723,2012,Jun
2012-06,New Mexico,698,4166,3562,121,7849,2012,Jun
2012-06,New York,2348,5894,11424,376,17694,2012,Jun
2012-06,North Carolina,14120,650,9506,224,10380,2012,Jun
2012-06,North Dakota,1661,1328,2498,26,3852,2012,Jun
2012-06,Ohio,0,20125,14019,462,34606,2012,Jun
2012-06,Oklahoma,0,10167,7651,338,18156,2012,Jun
2012-06,Oregon,23,9096,8210,0,17306,2012,Jun
2012-06,Pennsylvania,295,53,60185,0,60238,2012,Jun
2012-06,Puerto Rico,0,1027,205,6,1238,2012,Jun
2012-06,Rhode Island,0,740,601,8,1349,2012,Jun
2012-06,South Carolina,9447,6625,4286,140,11051,2012,Jun
2012-06,South Dakota,0,1599,2530,28,4157,2012,Jun
2012-06,Tennessee,7456,14810,10732,0,25542,2012,Jun
2012-06,Texas,12168,34768,28889,1311,64968,2012,Jun
2012-06,Utah,11577,2411,2967,42,5420,2012,Jun
2012-06,Vermont,0,1005,975,19,1999,2012,Jun
2012-06,Virgin Islands,0,30,8,0,38,2012,Jun
2012-06,Virginia,0,14451,10979,532,25962,2012,Jun
2012-06,Washington,10442,13288,10506,579,24373,2012,Jun
2012-06,West Virginia,184,4691,4743,101,9535,2012,Jun
2012-06,Wisconsin,7207,9771,7465,199,17435,2012,Jun
2012-06,Wyoming,309,1612,1739,37,3388,2012,Jun
2012-05,Alabama,396,11097,8917,256,20270,2012,May
2012-05,Alaska,0,2938,3077,95,6110,2012,May
2012-05,Arizona,5088,9374,6136,374,15884,2012,May
2012-05,Arkansas,1841,4128,4107,97,8332,2012,May
2012-05,California,28299,27699,27093,72,54864,2012,May
2012-05,Colorado,3477,12175,10380,368,22923,2012,May
2012-05,Connecticut,10556,4529,3187,144,7860,2012,May
2012-05,Delaware,0,1020,733,14,1767,2012,May
2012-05,District of Columbia,0,26,0,0,26,2012,May
2012-05,Florida,0,33310,17547,800,51657,2012,May
2012-05,Georgia,9078,8851,6254,145,15250,2012,May
2012-05,Guam,0,21,26,0,47,2012,May
2012-05,Hawaii,1408,0,0,0,0,2012,May
2012-05,Idaho,2702,2322,3293,59,5674,2012,May
2012-05,Illinois,55892,11987,9817,0,21804,2012,May
2012-05,Indiana,9028,11816,9152,380,21348,2012,May
2012-05,Iowa,7411,72,1916,21,2009,2012,May
2012-05,Kansas,1865,4819,4442,151,9412,2012,May
2012-05,Kentucky,187970,6851,6038,119,13008,2012,May
2012-05,Louisiana,0,7898,6675,238,14811,2012,May
2012-05,Maine,0,2574,2766,86,5426,2012,May
2012-05,Mariana Islands,0,0,1,0,1,2012,May
2012-05,Maryland,1,5249,3609,21,8879,2012,May
2012-05,Massachusetts,9453,4023,2152,190,6365,2012,May
2012-05,Michigan,19157,1137,8249,157,9543,2012,May
2012-05,Minnesota,15548,7335,7792,215,15342,2012,May
2012-05,Mississippi,426,4740,3882,97,8719,2012,May
2012-05,Missouri,3459,13959,10395,361,24715,2012,May
2012-05,Montana,936,2763,3990,53,6806,2012,May
2012-05,Nebraska,2911,85,1610,12,1707,2012,May
2012-05,Nevada,1669,4576,3268,174,8018,2012,May
2012-05,New Hampshire,2371,3518,2797,24,6339,2012,May
2012-05,New Jersey,0,4263,2498,191,6952,2012,May
2012-05,New Mexico,662,4058,3474,144,7676,2012,May
2012-05,New York,3325,6541,12175,411,19127,2012,May
2012-05,North Carolina,17474,625,9359,266,10250,2012,May
2012-05,North Dakota,1959,1512,2547,29,4088,2012,May
2012-05,Ohio,0,20446,13211,551,34208,2012,May
2012-05,Oklahoma,0,10357,7173,380,17910,2012,May
2012-05,Oregon,18,8652,8245,0,16897,2012,May
2012-05,Pennsylvania,261,36,62046,0,62082,2012,May
2012-05,Puerto Rico,0,1068,198,3,1269,2012,May
2012-05,Rhode Island,0,841,680,15,1536,2012,May
2012-05,South Carolina,7959,7126,3983,114,11223,2012,May
2012-05,South Dakota,0,1819,2508,41,4368,2012,May
2012-05,Tennessee,6391,14337,9980,0,24317,2012,May
2012-05,Texas,13009,34541,28197,1320,64058,2012,May
2012-05,Utah,10927,2430,2967,61,5458,2012,May
2012-05,Vermont,0,995,1122,19,2136,2012,May
2012-05,Virgin Islands,0,41,3,0,44,2012,May
2012-05,Virginia,0,14213,10795,551,25559,2012,May
2012-05,Washington,10892,13651,9650,492,23793,2012,May
2012-05,West Virginia,369,5025,4748,105,9878,2012,May
2012-05,Wisconsin,10437,10997,8077,223,19297,2012,May
2012-05,Wyoming,355,1780,1830,31,3641,2012,May
2012-04,Alabama,476,11518,9586,236,21340,2012,Apr
2012-04,Alaska,0,3274,3427,122,6823,2012,Apr
2012-04,Arizona,3894,10656,6984,371,18011,2012,Apr
2012-04,Arkansas,3680,4299,4209,86,8594,2012,Apr
2012-04,California,29961,29500,30211,59,59770,2012,Apr
2012-04,Colorado,4742,12909,11210,300,24419,2012,Apr
2012-04,Connecticut,10471,4895,3659,144,8698,2012,Apr
2012-04,Delaware,0,1096,839,21,1956,2012,Apr
2012-04,District of Columbia,0,27,1,0,28,2012,Apr
2012-04,Florida,0,34847,18257,703,53807,2012,Apr
2012-04,Georgia,8422,9481,6670,137,16288,2012,Apr
2012-04,Guam,0,26,38,3,67,2012,Apr
2012-04,Hawaii,1599,0,0,0,0,2012,Apr
2012-04,Idaho,2827,2509,3720,81,6310,2012,Apr
2012-04,Illinois,67212,14524,11497,0,26021,2012,Apr
2012-04,Indiana,11986,13520,10411,405,24336,2012,Apr
2012-04,Iowa,8134,116,2712,23,2851,2012,Apr
2012-04,Kansas,1358,5453,4948,168,10569,2012,Apr
2012-04,Kentucky,186399,7521,7238,125,14884,2012,Apr
2012-04,Louisiana,0,8397,6858,259,15514,2012,Apr
2012-04,Maine,0,3191,3070,86,6347,2012,Apr
2012-04,Mariana Islands,0,0,2,0,2,2012,Apr
2012-04,Maryland,20,5555,4361,43,9959,2012,Apr
2012-04,Massachusetts,8687,4231,2670,235,7136,2012,Apr
2012-04,Michigan,20773,1314,10018,177,11509,2012,Apr
2012-04,Minnesota,16217,9004,10769,253,20026,2012,Apr
2012-04,Mississippi,399,4656,4067,96,8819,2012,Apr
2012-04,Missouri,4017,15210,12050,394,27654,2012,Apr
2012-04,Montana,1124,3097,4180,51,7328,2012,Apr
2012-04,Nebraska,3372,72,1934,10,2016,2012,Apr
2012-04,Nevada,2459,4683,3846,176,8705,2012,Apr
2012-04,New Hampshire,2663,4066,3128,32,7226,2012,Apr
2012-04,New Jersey,0,4047,2685,172,6904,2012,Apr
2012-04,New Mexico,592,4246,3779,146,8171,2012,Apr
2012-04,New York,3046,6768,15285,519,22572,2012,Apr
2012-04,North Carolina,16909,595,10061,248,10904,2012,Apr
2012-04,North Dakota,1404,1956,3032,29,5017,2012,Apr
2012-04,Ohio,0,25352,15717,610,41679,2012,Apr
2012-04,Oklahoma,0,10982,8339,440,19761,2012,Apr
2012-04,Oregon,26,10426,9978,0,20404,2012,Apr
2012-04,Pennsylvania,235,29,71424,1,71454,2012,Apr
2012-04,Puerto Rico,0,980,152,8,1140,2012,Apr
2012-04,Rhode Island,0,953,720,17,1690,2012,Apr
2012-04,South Carolina,5724,7911,4404,159,12474,2012,Apr
2012-04,South Dakota,0,2122,2937,42,5101,2012,Apr
2012-04,Tennessee,6058,15736,10927,0,26663,2012,Apr
2012-04,Texas,12043,36296,28840,1282,66418,2012,Apr
2012-04,Utah,11153,2968,3317,82,6367,2012,Apr
2012-04,Vermont,0,1321,1468,27,2816,2012,Apr
2012-04,Virgin Islands,0,25,1,0,26,2012,Apr
2012-04,Virginia,0,17649,12196,594,30439,2012,Apr
2012-04,Washington,12297,14790,11022,617,26429,2012,Apr
2012-04,West Virginia,280,5629,5942,107,11678,2012,Apr
2012-04,Wisconsin,13383,14046,11444,260,25750,2012,Apr
2012-04,Wyoming,372,1786,1974,39,3799,2012,Apr
2012-03,Alabama,596,15995,12285,358,28638,2012,Mar
2012-03,Alaska,0,3047,3112,145,6304,2012,Mar
2012-03,Arizona,6413,13484,9115,466,23065,2012,Mar
2012-03,Arkansas,3302,6928,6170,107,13205,2012,Mar
2012-03,California,31724,36137,38797,74,75008,2012,Mar
2012-03,Colorado,4787,16271,14039,362,30672,2012,Mar
2012-03,Connecticut,11431,6139,4498,163,10800,2012,Mar
2012-03,Delaware,0,1350,1057,34,2441,2012,Mar
2012-03,District of Columbia,0,34,0,0,34,2012,Mar
2012-03,Florida,0,41823,21504,836,64163,2012,Mar
2012-03,Georgia,11662,14631,9607,277,24515,2012,Mar
2012-03,Guam,0,30,36,3,69,2012,Mar
2012-03,Hawaii,1547,0,0,0,0,2012,Mar
2012-03,Idaho,2808,3474,5160,118,8752,2012,Mar
2012-03,Illinois,72936,17725,14376,0,32101,2012,Mar
2012-03,Indiana,12257,18763,13250,672,32685,2012,Mar
2012-03,Iowa,10534,162,3926,25,4113,2012,Mar
2012-03,Kansas,1203,8582,7394,248,16224,2012,Mar
2012-03,Kentucky,185109,11306,9638,162,21106,2012,Mar
2012-03,Louisiana,0,11125,8996,347,20468,2012,Mar
2012-03,Maine,0,4007,3768,103,7878,2012,Mar
2012-03,Mariana Islands,0,0,0,0,0,2012,Mar
2012-03,Maryland,8,6244,5099,46,11389,2012,Mar
2012-03,Massachusetts,9842,5410,3128,163,8701,2012,Mar
2012-03,Michigan,24910,1575,12952,186,14713,2012,Mar
2012-03,Minnesota,18431,10954,12722,305,23981,2012,Mar
2012-03,Mississippi,493,6661,5848,139,12648,2012,Mar
2012-03,Missouri,4623,20609,15430,617,36656,2012,Mar
2012-03,Montana,1379,3784,4832,65,8681,2012,Mar
2012-03,Nebraska,4354,124,2542,8,2674,2012,Mar
2012-03,Nevada,1672,5913,4642,211,10766,2012,Mar
2012-03,New Hampshire,2824,4593,3402,24,8019,2012,Mar
2012-03,New Jersey,0,4266,3154,166,7586,2012,Mar
2012-03,New Mexico,611,5722,5160,249,11131,2012,Mar
2012-03,New York,2886,8068,17056,552,25676,2012,Mar
2012-03,North Carolina,22750,746,12962,429,14137,2012,Mar
2012-03,North Dakota,1745,2657,3621,49,6327,2012,Mar
2012-03,Ohio,0,33749,19245,886,53880,2012,Mar
2012-03,Oklahoma,0,14529,10953,565,26047,2012,Mar
2012-03,Oregon,65,12906,12430,0,25336,2012,Mar
2012-03,Pennsylvania,280,64,92661,0,92725,2012,Mar
2012-03,Puerto Rico,0,1249,187,4,1440,2012,Mar
2012-03,Rhode Island,0,1167,934,16,2117,2012,Mar
2012-03,South Carolina,6909,11548,6054,211,17813,2012,Mar
2012-03,South Dakota,0,2847,3863,59,6769,2012,Mar
2012-03,Tennessee,5440,19732,14661,0,34393,2012,Mar
2012-03,Texas,21989,47874,37409,1596,86879,2012,Mar
2012-03,Utah,10779,4131,4265,72,8468,2012,Mar
2012-03,Vermont,0,1679,1776,32,3487,2012,Mar
2012-03,Virgin Islands,0,15,1,0,16,2012,Mar
2012-03,Virginia,0,21304,14545,753,36602,2012,Mar
2012-03,Washington,12738,17010,12812,822,30644,2012,Mar
2012-03,West Virginia,385,7815,7501,142,15458,2012,Mar
2012-03,Wisconsin,14127,17351,14968,331,32650,2012,Mar
2012-03,Wyoming,424,2352,2485,36,4873,2012,Mar
2012-02,Alabama,573,18348,13565,312,32225,2012,Feb
2012-02,Alaska,0,2622,2353,118,5093,2012,Feb
2012-02,Arizona,3002,14082,8959,387,23428,2012,Feb
2012-02,Arkansas,2742,8513,7724,114,16351,2012,Feb
2012-02,California,25314,30902,31877,72,62851,2012,Feb
2012-02,Colorado,2752,17069,14133,358,31560,2012,Feb
2012-02,Connecticut,9696,5957,4073,133,10163,2012,Feb
2012-02,Delaware,0,1463,950,28,2441,2012,Feb
2012-02,District of Columbia,0,36,2,0,38,2012,Feb
2012-02,Florida,0,43744,22852,747,67343,2012,Feb
2012-02,Georgia,11666,18514,11296,216,30026,2012,Feb
2012-02,Guam,0,43,41,5,89,2012,Feb
2012-02,Hawaii,1257,0,0,0,0,2012,Feb
2012-02,Idaho,2264,3273,4340,78,7691,2012,Feb
2012-02,Illinois,55426,17750,14271,0,32021,2012,Feb
2012-02,Indiana,9076,19808,14257,568,34633,2012,Feb
2012-02,Iowa,11797,153,3884,23,4060,2012,Feb
2012-02,Kansas,1311,8293,7353,237,15883,2012,Feb
2012-02,Kentucky,180668,14498,11882,202,26582,2012,Feb
2012-02,Louisiana,0,12534,9441,248,22223,2012,Feb
2012-02,Maine,0,3446,3473,94,7013,2012,Feb
2012-02,Mariana Islands,0,0,0,0,0,2012,Feb
2012-02,Maryland,39,6192,5519,58,11769,2012,Feb
2012-02,Massachusetts,8308,4431,2478,176,7085,2012,Feb
2012-02,Michigan,24751,1492,12631,239,14362,2012,Feb
2012-02,Minnesota,14201,9320,9761,270,19351,2012,Feb
2012-02,Mississippi,545,8447,7201,135,15783,2012,Feb
2012-02,Missouri,3485,23012,16630,597,40239,2012,Feb
2012-02,Montana,1207,3705,4128,73,7906,2012,Feb
2012-02,Nebraska,4458,96,2418,23,2537,2012,Feb
2012-02,Nevada,1809,5623,3881,210,9714,2012,Feb
2012-02,New Hampshire,2630,4297,3128,43,7468,2012,Feb
2012-02,New Jersey,0,3556,2862,127,6545,2012,Feb
2012-02,New Mexico,754,5702,4863,159,10724,2012,Feb
2012-02,New York,2765,8269,17120,561,25950,2012,Feb
2012-02,North Carolina,24362,857,16115,482,17454,2012,Feb
2012-02,North Dakota,1169,2569,3031,53,5653,2012,Feb
2012-02,Ohio,0,35526,19840,770,56136,2012,Feb
2012-02,Oklahoma,0,15562,11793,443,27798,2012,Feb
2012-02,Oregon,35,12089,11200,0,23289,2012,Feb
2012-02,Pennsylvania,239,67,89116,1,89184,2012,Feb
2012-02,Puerto Rico,0,1123,178,7,1308,2012,Feb
2012-02,Rhode Island,0,1142,793,14,1949,2012,Feb
2012-02,South Carolina,5497,15798,7433,287,23518,2012,Feb
2012-02,South Dakota,0,2818,3739,56,6613,2012,Feb
2012-02,Tennessee,5111,25658,17153,0,42811,2012,Feb
2012-02,Texas,13453,54703,40563,1424,96690,2012,Feb
2012-02,Utah,7682,3561,3811,49,7421,2012,Feb
2012-02,Vermont,0,1602,1501,28,3131,2012,Feb
2012-02,Virgin Islands,0,33,4,0,37,2012,Feb
2012-02,Virginia,0,24439,15704,833,40976,2012,Feb
2012-02,Washington,10962,16266,11830,708,28804,2012,Feb
2012-02,West Virginia,148,8774,8171,161,17106,2012,Feb
2012-02,Wisconsin,16860,18262,11969,321,30552,2012,Feb
2012-02,Wyoming,288,2094,2124,47,4265,2012,Feb
2012-01,Alabama,518,11998,11176,265,23439,2012,Jan
2012-01,Alaska,0,1645,1713,58,3416,2012,Jan
2012-01,Arizona,2946,9570,6969,321,16860,2012,Jan
2012-01,Arkansas,2372,4886,5554,80,10520,2012,Jan
2012-01,California,23099,25812,25757,59,51628,2012,Jan
2012-01,Colorado,2815,13711,11801,274,25786,2012,Jan
2012-01,Connecticut,9009,4894,3904,147,8945,2012,Jan
2012-01,Delaware,0,1168,820,23,2011,2012,Jan
2012-01,District of Columbia,0,43,2,0,45,2012,Jan
2012-01,Florida,4,34951,18761,587,54299,2012,Jan
2012-01,Georgia,10964,10796,8258,176,19230,2012,Jan
2012-01,Guam,0,29,42,3,74,2012,Jan
2012-01,Hawaii,1057,2,2,2,6,2012,Jan
2012-01,Idaho,2503,2368,3491,56,5915,2012,Jan
2012-01,Illinois,64346,13424,11581,0,25005,2012,Jan
2012-01,Indiana,5044,14224,10574,511,25309,2012,Jan
2012-01,Iowa,10390,142,3006,16,3164,2012,Jan
2012-01,Kansas,1688,6316,6557,205,13078,2012,Jan
2012-01,Kentucky,178454,8633,7855,154,16642,2012,Jan
2012-01,Louisiana,0,8549,9237,215,18001,2012,Jan
2012-01,Maine,0,2438,2777,91,5306,2012,Jan
2012-01,Mariana Islands,0,0,0,0,0,2012,Jan
2012-01,Maryland,1,4431,4196,28,8655,2012,Jan
2012-01,Massachusetts,7171,4008,2157,128,6293,2012,Jan
2012-01,Michigan,19146,1224,8653,166,10043,2012,Jan
2012-01,Minnesota,12424,7238,7956,196,15390,2012,Jan
2012-01,Mississippi,525,4703,6212,98,11013,2012,Jan
2012-01,Missouri,2910,15948,12991,442,29381,2012,Jan
2012-01,Montana,998,2684,3218,50,5952,2012,Jan
2012-01,Nebraska,3996,75,2613,17,2705,2012,Jan
2012-01,Nevada,1343,4416,3282,165,7863,2012,Jan
2012-01,New Hampshire,2323,3406,2573,22,6001,2012,Jan
2012-01,New Jersey,0,2920,2293,99,5312,2012,Jan
2012-01,New Mexico,425,3960,3531,140,7631,2012,Jan
2012-01,New York,2703,6654,11877,402,18933,2012,Jan
2012-01,North Carolina,19968,564,11920,390,12874,2012,Jan
2012-01,North Dakota,642,1862,2709,42,4613,2012,Jan
2012-01,Ohio,0,22307,13742,532,36581,2012,Jan
2012-01,Oklahoma,0,11440,9760,372,21572,2012,Jan
2012-01,Oregon,45,8921,8346,1,17268,2012,Jan
2012-01,Pennsylvania,257,19,66405,0,66424,2012,Jan
2012-01,Puerto Rico,0,806,108,5,919,2012,Jan
2012-01,Rhode Island,0,868,681,16,1565,2012,Jan
2012-01,South Carolina,5424,8972,5218,156,14346,2012,Jan
2012-01,South Dakota,0,2000,3541,42,5583,2012,Jan
2012-01,Tennessee,3810,18029,12590,0,30619,2012,Jan
2012-01,Texas,10360,38234,34319,1196,73749,2012,Jan
2012-01,Utah,5689,2681,3052,53,5786,2012,Jan
2012-01,Vermont,0,945,1048,24,2017,2012,Jan
2012-01,Virgin Islands,2,23,5,0,28,2012,Jan
2012-01,Virginia,0,15822,11720,577,28119,2012,Jan
2012-01,Washington,9621,12273,8772,513,21558,2012,Jan
2012-01,West Virginia,257,5384,6047,137,11568,2012,Jan
2012-01,Wisconsin,22425,12254,8655,227,21136,2012,Jan
2012-01,Wyoming,302,1513,1622,25,3160,2012,Jan
2011-12,Alabama,496,17651,28564,260,46475,2011,Dec
2011-12,Alaska,0,2851,3715,93,6659,2011,Dec
2011-12,Arizona,3119,12018,11689,366,24073,2011,Dec
2011-12,Arkansas,2714,6900,13747,83,20730,2011,Dec
2011-12,California,23007,29452,36425,54,65931,2011,Dec
2011-12,Colorado,1,16990,19525,0,36515,2011,Dec
2011-12,Connecticut,7833,5210,5383,163,10756,2011,Dec
2011-12,Delaware,0,1430,1760,29,3219,2011,Dec
2011-12,District of Columbia,0,19,2,0,21,2011,Dec
2011-12,Florida,0,40463,31791,0,72254,2011,Dec
2011-12,Georgia,6833,15777,22801,190,38768,2011,Dec
2011-12,Guam,0,38,38,1,77,2011,Dec
2011-12,Hawaii,1187,0,0,0,0,2011,Dec
2011-12,Idaho,1737,3584,6887,93,10564,2011,Dec
2011-12,Illinois,62133,15946,18596,0,34542,2011,Dec
2011-12,Indiana,5267,16616,19842,435,36893,2011,Dec
2011-12,Iowa,8089,145,6670,12,6827,2011,Dec
2011-12,Kansas,1027,7204,11848,241,19293,2011,Dec
2011-12,Kentucky,176893,12400,19464,174,32038,2011,Dec
2011-12,Louisiana,0,12503,24866,218,37587,2011,Dec
2011-12,Maine,0,3061,5123,97,8281,2011,Dec
2011-12,Mariana Islands,0,0,0,0,0,2011,Dec
2011-12,Maryland,0,4522,7805,36,12363,2011,Dec
2011-12,Massachusetts,6960,4399,2948,115,7462,2011,Dec
2011-12,Michigan,17244,1394,17339,141,18874,2011,Dec
2011-12,Minnesota,11222,8269,13584,230,22083,2011,Dec
2011-12,Mississippi,342,7880,19013,149,27042,2011,Dec
2011-12,Missouri,2367,19205,23887,486,43578,2011,Dec
2011-12,Montana,602,3475,6151,39,9665,2011,Dec
2011-12,Nebraska,3947,135,5431,24,5590,2011,Dec
2011-12,Nevada,1239,5671,5643,113,11427,2011,Dec
2011-12,New Hampshire,1981,3771,3915,36,7722,2011,Dec
2011-12,New Jersey,0,2928,3883,130,6941,2011,Dec
2011-12,New Mexico,491,5083,6281,119,11483,2011,Dec
2011-12,New York,2953,6497,21271,366,28134,2011,Dec
2011-12,North Carolina,15879,653,27849,311,28813,2011,Dec
2011-12,North Dakota,1175,1811,4256,43,6110,2011,Dec
2011-12,Ohio,0,29717,28886,594,59197,2011,Dec
2011-12,Oklahoma,0,13809,18920,367,33096,2011,Dec
2011-12,Oregon,55,10490,13794,0,24284,2011,Dec
2011-12,Pennsylvania,760,32,83662,2,83696,2011,Dec
2011-12,Puerto Rico,0,1018,177,2,1197,2011,Dec
2011-12,Rhode Island,0,921,896,21,1838,2011,Dec
2011-12,South Carolina,3356,11221,13522,165,24908,2011,Dec
2011-12,South Dakota,0,2346,5734,42,8122,2011,Dec
2011-12,Tennessee,3499,24452,27923,0,52375,2011,Dec
2011-12,Texas,11735,55187,73202,1288,129677,2011,Dec
2011-12,Utah,9462,4498,8103,6,12607,2011,Dec
2011-12,Vermont,0,1198,1819,27,3044,2011,Dec
2011-12,Virgin Islands,75,28,6,0,34,2011,Dec
2011-12,Virginia,0,19470,23046,84,42600,2011,Dec
2011-12,Washington,8756,16005,15941,595,32541,2011,Dec
2011-12,West Virginia,91,8082,13332,137,21551,2011,Dec
2011-12,Wisconsin,38741,15127,13551,261,28939,2011,Dec
2011-12,Wyoming,195,2350,3227,40,5617,2011,Dec
2011-11,Alabama,386,11548,20228,176,31952,2011,Nov
2011-11,Alaska,0,2019,2783,75,4877,2011,Nov
2011-11,Arizona,2983,8315,8157,245,16717,2011,Nov
2011-11,Arkansas,1648,4022,12035,64,16121,2011,Nov
2011-11,California,19427,23885,30091,49,54025,2011,Nov
2011-11,Colorado,0,12727,15131,0,27858,2011,Nov
2011-11,Connecticut,7533,3855,4084,112,8051,2011,Nov
2011-11,Delaware,0,971,1402,18,2391,2011,Nov
2011-11,District of Columbia,0,33,0,0,33,2011,Nov
2011-11,Florida,2,30827,23480,0,54307,2011,Nov
2011-11,Georgia,6131,8691,14424,103,23218,2011,Nov
2011-11,Guam,0,23,12,1,36,2011,Nov
2011-11,Hawaii,1110,0,0,0,0,2011,Nov
2011-11,Idaho,1248,2269,4537,67,6873,2011,Nov
2011-11,Illinois,56320,12039,16397,0,28436,2011,Nov
2011-11,Indiana,5217,11350,17074,324,28748,2011,Nov
2011-11,Iowa,7947,134,6094,13,6241,2011,Nov
2011-11,Kansas,970,5262,10033,165,15460,2011,Nov
2011-11,Kentucky,175670,7447,15122,124,22693,2011,Nov
2011-11,Louisiana,0,8077,17355,181,25613,2011,Nov
2011-11,Maine,0,2087,4270,65,6422,2011,Nov
2011-11,Mariana Islands,0,0,0,0,0,2011,Nov
2011-11,Maryland,9,3760,7540,28,11328,2011,Nov
2011-11,Massachusetts,6660,3475,2605,80,6160,2011,Nov
2011-11,Michigan,14281,1005,18342,92,19439,2011,Nov
2011-11,Minnesota,9437,5749,12848,184,18781,2011,Nov
2011-11,Mississippi,445,4776,14867,114,19757,2011,Nov
2011-11,Missouri,2291,12697,20547,315,33559,2011,Nov
2011-11,Montana,563,2134,4327,54,6515,2011,Nov
2011-11,Nebraska,2926,82,4494,13,4589,2011,Nov
2011-11,Nevada,1183,4176,4092,0,8268,2011,Nov
2011-11,New Hampshire,2392,2783,3236,30,6049,2011,Nov
2011-11,New Jersey,0,2504,3291,101,5896,2011,Nov
2011-11,New Mexico,531,3737,4418,82,8237,2011,Nov
2011-11,New York,3232,5030,20098,322,25450,2011,Nov
2011-11,North Carolina,13378,299,19954,210,20463,2011,Nov
2011-11,North Dakota,864,1332,3914,21,5267,2011,Nov
2011-11,Ohio,0,21362,24640,436,46438,2011,Nov
2011-11,Oklahoma,1,9810,14561,297,24668,2011,Nov
2011-11,Oregon,46,7772,9906,0,17678,2011,Nov
2011-11,Pennsylvania,196,24,73464,0,73488,2011,Nov
2011-11,Puerto Rico,0,927,149,3,1079,2011,Nov
2011-11,Rhode Island,0,713,712,20,1445,2011,Nov
2011-11,South Carolina,3905,7743,9294,168,17205,2011,Nov
2011-11,South Dakota,0,1556,5038,47,6641,2011,Nov
2011-11,Tennessee,3224,16350,21019,0,37369,2011,Nov
2011-11,Texas,12407,35928,49253,904,86085,2011,Nov
2011-11,Utah,8940,3021,5120,0,8141,2011,Nov
2011-11,Vermont,0,865,1710,11,2586,2011,Nov
2011-11,Virgin Islands,74,15,3,0,18,2011,Nov
2011-11,Virginia,0,14798,19089,0,33887,2011,Nov
2011-11,Washington,8065,11354,11057,466,22877,2011,Nov
2011-11,West Virginia,191,4556,12314,74,16944,2011,Nov
2011-11,Wisconsin,44346,12245,15947,194,28386,2011,Nov
2011-11,Wyoming,199,1501,2232,31,3764,2011,Nov
2011-10,Alabama,427,9228,12879,153,22260,2011,Oct
2011-10,Alaska,0,2910,3813,96,6819,2011,Oct
2011-10,Arizona,3813,7915,6449,202,14566,2011,Oct
2011-10,Arkansas,1811,3654,8444,54,12152,2011,Oct
2011-10,California,28127,26693,28249,44,54986,2011,Oct
2011-10,Colorado,0,11441,13612,0,25053,2011,Oct
2011-10,Connecticut,7446,3643,3650,84,7377,2011,Oct
2011-10,Delaware,0,944,1137,17,2098,2011,Oct
2011-10,District of Columbia,0,35,0,0,35,2011,Oct
2011-10,Florida,5,29491,18379,0,47870,2011,Oct
2011-10,Georgia,6552,7788,11056,146,18990,2011,Oct
2011-10,Guam,0,25,23,2,50,2011,Oct
2011-10,Hawaii,1080,0,0,0,0,2011,Oct
2011-10,Idaho,1715,2051,4538,49,6638,2011,Oct
2011-10,Illinois,46508,10417,12084,0,22501,2011,Oct
2011-10,Indiana,4966,10498,12206,354,23058,2011,Oct
2011-10,Iowa,7331,99,4192,15,4306,2011,Oct
2011-10,Kansas,912,4628,6958,166,11752,2011,Oct
2011-10,Kentucky,174243,6373,10721,90,17184,2011,Oct
2011-10,Louisiana,0,7426,13823,145,21394,2011,Oct
2011-10,Maine,0,2256,5955,49,8260,2011,Oct
2011-10,Mariana Islands,0,0,0,0,0,2011,Oct
2011-10,Maryland,0,3556,5214,19,8789,2011,Oct
2011-10,Massachusetts,7485,3266,2261,90,5617,2011,Oct
2011-10,Michigan,14192,1026,13687,119,14832,2011,Oct
2011-10,Minnesota,8660,5784,17421,196,23401,2011,Oct
2011-10,Mississippi,368,3891,8707,110,12708,2011,Oct
2011-10,Missouri,2232,12526,16426,311,29263,2011,Oct
2011-10,Montana,626,2251,6187,31,8469,2011,Oct
2011-10,Nebraska,2378,71,3318,6,3395,2011,Oct
2011-10,Nevada,834,3938,3211,0,7149,2011,Oct
2011-10,New Hampshire,2007,2809,3337,50,6196,2011,Oct
2011-10,New Jersey,0,2473,2514,0,4987,2011,Oct
2011-10,New Mexico,392,3760,3971,107,7838,2011,Oct
2011-10,New York,2938,5101,17748,297,23146,2011,Oct
2011-10,North Carolina,12259,237,14253,224,14714,2011,Oct
2011-10,North Dakota,375,1506,5449,19,6974,2011,Oct
2011-10,Ohio,1,19153,16836,430,36419,2011,Oct
2011-10,Oklahoma,0,7583,9610,239,17432,2011,Oct
2011-10,Oregon,23,7028,8737,0,15765,2011,Oct
2011-10,Pennsylvania,157,26,62938,1,62965,2011,Oct
2011-10,Puerto Rico,0,947,171,1,1119,2011,Oct
2011-10,Rhode Island,0,646,693,17,1356,2011,Oct
2011-10,South Carolina,4351,5432,6442,106,11980,2011,Oct
2011-10,South Dakota,0,1515,6322,27,7864,2011,Oct
2011-10,Tennessee,10913,13883,14326,0,28209,2011,Oct
2011-10,Texas,14304,30160,38398,852,69410,2011,Oct
2011-10,Utah,7334,2102,4032,0,6134,2011,Oct
2011-10,Vermont,0,845,1781,18,2644,2011,Oct
2011-10,Virgin Islands,53,29,1,0,30,2011,Oct
2011-10,Virginia,0,13968,14629,0,28597,2011,Oct
2011-10,Washington,8953,10657,10328,377,21362,2011,Oct
2011-10,West Virginia,231,4643,8595,92,13330,2011,Oct
2011-10,Wisconsin,517,9103,14772,195,24070,2011,Oct
2011-10,Wyoming,229,1332,1988,18,3338,2011,Oct
2011-09,Alabama,408,9549,10728,196,20473,2011,Sep
2011-09,Alaska,0,1965,3014,68,5047,2011,Sep
2011-09,Arizona,2413,7936,6614,280,14830,2011,Sep
2011-09,Arkansas,1756,4168,6849,70,11087,2011,Sep
2011-09,California,23573,22197,23657,39,45893,2011,Sep
2011-09,Colorado,0,11700,12309,0,24009,2011,Sep
2011-09,Connecticut,7494,3662,3220,94,6976,2011,Sep
2011-09,Delaware,0,830,845,31,1706,2011,Sep
2011-09,District of Columbia,0,38,1,0,39,2011,Sep
2011-09,Florida,0,29341,16267,0,45608,2011,Sep
2011-09,Georgia,6651,8329,8954,124,17407,2011,Sep
2011-09,Guam,0,13,16,5,34,2011,Sep
2011-09,Hawaii,991,0,0,0,0,2011,Sep
2011-09,Idaho,1889,2207,4158,43,6408,2011,Sep
2011-09,Illinois,44902,9915,10724,0,20639,2011,Sep
2011-09,Indiana,6165,9423,10639,281,20343,2011,Sep
2011-09,Iowa,6848,88,3390,11,3489,2011,Sep
2011-09,Kansas,1070,3649,5526,115,9290,2011,Sep
2011-09,Kentucky,173301,6331,8904,103,15338,2011,Sep
2011-09,Louisiana,0,8856,15185,207,24248,2011,Sep
2011-09,Maine,0,2219,4274,49,6542,2011,Sep
2011-09,Mariana Islands,0,0,0,0,0,2011,Sep
2011-09,Maryland,0,3307,3910,19,7236,2011,Sep
2011-09,Massachusetts,6952,3279,2113,85,5477,2011,Sep
2011-09,Michigan,15119,945,12997,123,14065,2011,Sep
2011-09,Minnesota,8379,5492,15315,179,20986,2011,Sep
2011-09,Mississippi,407,3739,7119,92,10950,2011,Sep
2011-09,Missouri,2108,12359,12894,330,25583,2011,Sep
2011-09,Montana,586,2442,5001,36,7479,2011,Sep
2011-09,Nebraska,2375,81,2324,14,2419,2011,Sep
2011-09,Nevada,1139,4048,3066,0,7114,2011,Sep
2011-09,New Hampshire,2267,2928,2776,16,5720,2011,Sep
2011-09,New Jersey,0,2403,2200,0,4603,2011,Sep
2011-09,New Mexico,458,3428,3596,94,7118,2011,Sep
2011-09,New York,3069,4894,16404,341,21639,2011,Sep
2011-09,North Carolina,12120,257,11602,210,12069,2011,Sep
2011-09,North Dakota,364,1203,3905,23,5131,2011,Sep
2011-09,Ohio,0,17864,14411,450,32725,2011,Sep
2011-09,Oklahoma,0,7612,8896,293,16801,2011,Sep
2011-09,Oregon,42,6952,9093,0,16045,2011,Sep
2011-09,Pennsylvania,168,0,58431,0,58431,2011,Sep
2011-09,Puerto Rico,0,857,198,3,1058,2011,Sep
2011-09,Rhode Island,0,660,580,15,1255,2011,Sep
2011-09,South Carolina,4027,5551,5992,134,11677,2011,Sep
2011-09,South Dakota,0,1478,4011,30,5519,2011,Sep
2011-09,Tennessee,3445,13175,12204,0,25379,2011,Sep
2011-09,Texas,11127,29410,41207,760,71377,2011,Sep
2011-09,Utah,6228,2286,3979,0,6265,2011,Sep
2011-09,Vermont,0,924,1430,18,2372,2011,Sep
2011-09,Virgin Islands,38,24,4,0,28,2011,Sep
2011-09,Virginia,0,12701,12134,0,24835,2011,Sep
2011-09,Washington,7960,9924,9314,353,19591,2011,Sep
2011-09,West Virginia,151,4378,7055,85,11518,2011,Sep
2011-09,Wisconsin,30,8176,12953,156,21285,2011,Sep
2011-09,Wyoming,239,1531,2206,20,3757,2011,Sep
2011-08,Alabama,450,9863,10576,161,20600,2011,Aug
2011-08,Alaska,0,2221,3359,59,5639,2011,Aug
2011-08,Arizona,2666,7684,6476,252,14412,2011,Aug
2011-08,Arkansas,3422,3651,5251,66,8968,2011,Aug
2011-08,California,25109,23431,27619,0,51050,2011,Aug
2011-08,Colorado,0,11775,11469,0,23244,2011,Aug
2011-08,Connecticut,6610,3912,2964,90,6966,2011,Aug
2011-08,Delaware,0,770,713,17,1500,2011,Aug
2011-08,District of Columbia,0,11,0,0,11,2011,Aug
2011-08,Florida,2,29668,15927,0,45595,2011,Aug
2011-08,Georgia,7492,8237,7957,122,16316,2011,Aug
2011-08,Guam,0,15,20,0,35,2011,Aug
2011-08,Hawaii,1186,0,0,0,0,2011,Aug
2011-08,Idaho,1805,2068,3527,46,5641,2011,Aug
2011-08,Illinois,44880,9947,10717,0,20664,2011,Aug
2011-08,Indiana,7165,9898,9924,338,20160,2011,Aug
2011-08,Iowa,7350,69,2629,11,2709,2011,Aug
2011-08,Kansas,1478,4080,5373,126,9579,2011,Aug
2011-08,Kentucky,171241,6336,7407,91,13834,2011,Aug
2011-08,Louisiana,0,7465,10194,163,17822,2011,Aug
2011-08,Maine,0,2089,3125,51,5265,2011,Aug
2011-08,Mariana Islands,0,0,0,0,0,2011,Aug
2011-08,Maryland,0,3647,3950,19,7616,2011,Aug
2011-08,Massachusetts,7178,3484,2114,94,5692,2011,Aug
2011-08,Michigan,14639,986,10367,89,11442,2011,Aug
2011-08,Minnesota,9400,5288,10716,154,16158,2011,Aug
2011-08,Mississippi,484,4273,6099,106,10478,2011,Aug
2011-08,Missouri,2652,12579,11701,284,24564,2011,Aug
2011-08,Montana,594,2425,3871,34,6330,2011,Aug
2011-08,Nebraska,2317,85,2189,10,2284,2011,Aug
2011-08,Nevada,1106,4140,3276,0,7416,2011,Aug
2011-08,New Hampshire,2132,2589,2260,12,4861,2011,Aug
2011-08,New Jersey,0,2426,2047,0,4473,2011,Aug
2011-08,New Mexico,552,3758,3518,103,7379,2011,Aug
2011-08,New York,3667,4973,11860,237,17070,2011,Aug
2011-08,North Carolina,13217,245,10475,215,10935,2011,Aug
2011-08,North Dakota,295,1346,2869,26,4241,2011,Aug
2011-08,Ohio,0,17325,13410,345,31080,2011,Aug
2011-08,Oklahoma,0,8132,8191,291,16614,2011,Aug
2011-08,Oregon,13,6591,7234,0,13825,2011,Aug
2011-08,Pennsylvania,264,6,54551,0,54557,2011,Aug
2011-08,Puerto Rico,0,794,173,1,968,2011,Aug
2011-08,Rhode Island,0,686,576,7,1269,2011,Aug
2011-08,South Carolina,5400,5638,5374,108,11120,2011,Aug
2011-08,South Dakota,0,1595,3239,32,4866,2011,Aug
2011-08,Tennessee,4620,13887,12061,0,25948,2011,Aug
2011-08,Texas,10783,30112,35200,865,66177,2011,Aug
2011-08,Utah,115545,2198,3042,0,5240,2011,Aug
2011-08,Vermont,0,833,1087,16,1936,2011,Aug
2011-08,Virgin Islands,69,18,2,0,20,2011,Aug
2011-08,Virginia,0,12084,10470,0,22554,2011,Aug
2011-08,Washington,8169,10265,8597,422,19284,2011,Aug
2011-08,West Virginia,197,4306,5530,89,9925,2011,Aug
2011-08,Wisconsin,66,8254,10196,124,18574,2011,Aug
2011-08,Wyoming,360,1361,1840,26,3227,2011,Aug
2011-07,Alabama,348,8988,8152,161,17301,2011,Jul
2011-07,Alaska,0,2146,2457,61,4664,2011,Jul
2011-07,Arizona,2864,7367,4997,244,12608,2011,Jul
2011-07,Arkansas,2161,3504,3806,46,7356,2011,Jul
2011-07,California,19266,21925,21196,0,43121,2011,Jul
2011-07,Colorado,0,10070,8781,0,18851,2011,Jul
2011-07,Connecticut,7549,3390,2501,76,5967,2011,Jul
2011-07,Delaware,0,737,561,18,1316,2011,Jul
2011-07,District of Columbia,0,3,0,0,3,2011,Jul
2011-07,Florida,0,27240,13412,0,40652,2011,Jul
2011-07,Georgia,6524,7543,5779,138,13460,2011,Jul
2011-07,Guam,0,17,19,0,36,2011,Jul
2011-07,Hawaii,1001,0,0,0,0,2011,Jul
2011-07,Idaho,1510,1798,2685,46,4529,2011,Jul
2011-07,Illinois,41386,8812,7396,0,16208,2011,Jul
2011-07,Indiana,2082,8622,6938,240,15800,2011,Jul
2011-07,Iowa,5939,37,1812,17,1866,2011,Jul
2011-07,Kansas,1370,3629,3734,111,7474,2011,Jul
2011-07,Kentucky,169071,5763,5421,74,11258,2011,Jul
2011-07,Louisiana,0,7296,6809,175,14280,2011,Jul
2011-07,Maine,0,1952,2629,36,4617,2011,Jul
2011-07,Mariana Islands,0,0,0,0,0,2011,Jul
2011-07,Maryland,0,3086,3197,23,6306,2011,Jul
2011-07,Massachusetts,6377,3114,1600,87,4801,2011,Jul
2011-07,Michigan,12736,1040,6613,100,7753,2011,Jul
2011-07,Minnesota,6737,4214,6233,150,10597,2011,Jul
2011-07,Mississippi,376,3772,3919,78,7769,2011,Jul
2011-07,Missouri,1963,11070,8276,289,19635,2011,Jul
2011-07,Montana,531,2157,3281,44,5482,2011,Jul
2011-07,Nebraska,1784,56,1331,7,1394,2011,Jul
2011-07,Nevada,1243,3816,2804,0,6620,2011,Jul
2011-07,New Hampshire,2200,2411,1990,16,4417,2011,Jul
2011-07,New Jersey,0,2449,1754,0,4203,2011,Jul
2011-07,New Mexico,632,3167,2890,80,6137,2011,Jul
2011-07,New York,2831,4069,8408,212,12689,2011,Jul
2011-07,North Carolina,10918,242,7556,169,7967,2011,Jul
2011-07,North Dakota,404,947,2007,16,2970,2011,Jul
2011-07,Ohio,0,15404,10937,415,26756,2011,Jul
2011-07,Oklahoma,0,7373,6184,245,13802,2011,Jul
2011-07,Oregon,6,6289,6345,0,12634,2011,Jul
2011-07,Pennsylvania,143,0,45503,0,45503,2011,Jul
2011-07,Puerto Rico,0,633,163,3,799,2011,Jul
2011-07,Rhode Island,0,570,437,11,1018,2011,Jul
2011-07,South Carolina,3854,4797,3631,114,8542,2011,Jul
2011-07,South Dakota,0,1227,2133,25,3385,2011,Jul
2011-07,Tennessee,8077,12455,8834,0,21289,2011,Jul
2011-07,Texas,12270,28000,24870,760,53630,2011,Jul
2011-07,Utah,125275,1956,2536,0,4492,2011,Jul
2011-07,Vermont,0,731,777,16,1524,2011,Jul
2011-07,Virgin Islands,81,18,3,0,21,2011,Jul
2011-07,Virginia,0,13419,9388,0,22807,2011,Jul
2011-07,Washington,7107,9471,7452,393,17316,2011,Jul
2011-07,West Virginia,231,3890,4236,70,8196,2011,Jul
2011-07,Wisconsin,19,7359,6356,110,13825,2011,Jul
2011-07,Wyoming,231,1269,1485,20,2774,2011,Jul
2011-06,Alabama,402,9388,7951,153,17492,2011,Jun
2011-06,Alaska,0,2201,2254,66,4521,2011,Jun
2011-06,Arizona,2737,7204,4908,220,12332,2011,Jun
2011-06,Arkansas,3210,3496,3390,64,6950,2011,Jun
2011-06,California,26673,24632,24012,0,48644,2011,Jun
2011-06,Colorado,0,10394,9130,0,19524,2011,Jun
2011-06,Connecticut,8546,3866,2510,94,6470,2011,Jun
2011-06,Delaware,0,732,597,18,1347,2011,Jun
2011-06,District of Columbia,0,6,0,0,6,2011,Jun
2011-06,Florida,0,27744,13091,0,40835,2011,Jun
2011-06,Georgia,7281,7746,5227,114,13087,2011,Jun
2011-06,Guam,0,18,19,2,39,2011,Jun
2011-06,Hawaii,1024,0,0,0,0,2011,Jun
2011-06,Idaho,1267,1918,3067,46,5031,2011,Jun
2011-06,Illinois,39691,9059,7372,0,16431,2011,Jun
2011-06,Indiana,6450,8876,6861,251,15988,2011,Jun
2011-06,Iowa,7161,43,1803,8,1854,2011,Jun
2011-06,Kansas,1680,3434,3369,87,6890,2011,Jun
2011-06,Kentucky,168982,5729,5255,89,11073,2011,Jun
2011-06,Louisiana,0,7322,5973,147,13442,2011,Jun
2011-06,Maine,0,1945,2184,31,4160,2011,Jun
2011-06,Mariana Islands,0,0,0,0,0,2011,Jun
2011-06,Maryland,0,3277,2896,16,6189,2011,Jun
2011-06,Massachusetts,6739,3143,1598,77,4818,2011,Jun
2011-06,Michigan,15143,1177,6719,90,7986,2011,Jun
2011-06,Minnesota,9405,4862,6241,154,11257,2011,Jun
2011-06,Mississippi,453,3541,3283,63,6887,2011,Jun
2011-06,Missouri,2149,11684,7896,258,19838,2011,Jun
2011-06,Montana,542,2154,3325,42,5521,2011,Jun
2011-06,Nebraska,1884,73,1357,9,1439,2011,Jun
2011-06,Nevada,1357,3756,2919,0,6675,2011,Jun
2011-06,New Hampshire,2372,2373,1941,10,4324,2011,Jun
2011-06,New Jersey,0,2586,1806,0,4392,2011,Jun
2011-06,New Mexico,660,3492,2877,82,6451,2011,Jun
2011-06,New York,3349,4850,8697,225,13772,2011,Jun
2011-06,North Carolina,12014,241,7371,158,7770,2011,Jun
2011-06,North Dakota,332,895,2010,17,2922,2011,Jun
2011-06,Ohio,2,15226,9991,370,25587,2011,Jun
2011-06,Oklahoma,0,7401,5743,208,13352,2011,Jun
2011-06,Oregon,32,7074,7264,0,14338,2011,Jun
2011-06,Pennsylvania,205,1,46047,0,46048,2011,Jun
2011-06,Puerto Rico,0,807,126,5,938,2011,Jun
2011-06,Rhode Island,0,605,493,18,1116,2011,Jun
2011-06,South Carolina,4244,5043,3281,148,8472,2011,Jun
2011-06,South Dakota,0,1349,2127,35,3511,2011,Jun
2011-06,Tennessee,5343,12513,7998,0,20511,2011,Jun
2011-06,Texas,16669,28911,23268,766,52945,2011,Jun
2011-06,Utah,111880,2109,2798,0,4907,2011,Jun
2011-06,Vermont,0,801,872,10,1683,2011,Jun
2011-06,Virgin Islands,140,35,3,0,38,2011,Jun
2011-06,Virginia,0,10945,7884,0,18829,2011,Jun
2011-06,Washington,7520,9852,7829,407,18088,2011,Jun
2011-06,West Virginia,0,3924,3799,63,7786,2011,Jun
2011-06,Wisconsin,0,6548,6686,111,13345,2011,Jun
2011-06,Wyoming,336,1379,1541,26,2946,2011,Jun
2011-05,Alabama,367,8950,7192,151,16293,2011,May
2011-05,Alaska,0,2370,2530,54,4954,2011,May
2011-05,Arizona,2170,7868,5278,253,13399,2011,May
2011-05,Arkansas,3201,3659,3438,43,7140,2011,May
2011-05,California,20807,22849,22801,0,45650,2011,May
2011-05,Colorado,1,11276,9670,0,20946,2011,May
2011-05,Connecticut,8576,4046,2754,80,6880,2011,May
2011-05,Delaware,0,743,624,18,1385,2011,May
2011-05,District of Columbia,0,14,1,0,15,2011,May
2011-05,Florida,0,27882,12952,0,40834,2011,May
2011-05,Georgia,7002,7930,5154,113,13197,2011,May
2011-05,Guam,0,18,13,2,33,2011,May
2011-05,Hawaii,1041,0,0,0,0,2011,May
2011-05,Idaho,1259,1989,3283,46,5318,2011,May
2011-05,Illinois,37301,9700,8132,0,17832,2011,May
2011-05,Indiana,7484,8658,7073,241,15972,2011,May
2011-05,Iowa,9298,46,1809,6,1861,2011,May
2011-05,Kansas,1333,3852,3713,73,7638,2011,May
2011-05,Kentucky,165851,5872,5437,96,11405,2011,May
2011-05,Louisiana,0,6884,5585,128,12597,2011,May
2011-05,Maine,0,1926,2376,38,4340,2011,May
2011-05,Mariana Islands,0,0,0,0,0,2011,May
2011-05,Maryland,0,3630,3093,26,6749,2011,May
2011-05,Massachusetts,6994,3308,1533,110,4951,2011,May
2011-05,Michigan,17129,1222,7634,104,8960,2011,May
2011-05,Minnesota,12372,5661,6988,144,12793,2011,May
2011-05,Mississippi,417,3738,3252,60,7050,2011,May
2011-05,Missouri,2391,12186,8850,254,21290,2011,May
2011-05,Montana,687,2340,3613,41,5994,2011,May
2011-05,Nebraska,2041,78,1555,9,1642,2011,May
2011-05,Nevada,1678,4375,3208,0,7583,2011,May
2011-05,New Hampshire,1805,2341,2134,10,4485,2011,May
2011-05,New Jersey,0,2733,1908,0,4641,2011,May
2011-05,New Mexico,435,3627,2940,106,6673,2011,May
2011-05,New York,3591,5153,9953,250,15356,2011,May
2011-05,North Carolina,12226,222,7265,180,7667,2011,May
2011-05,North Dakota,412,1086,2288,17,3391,2011,May
2011-05,Ohio,0,17056,10842,359,28257,2011,May
2011-05,Oklahoma,0,7472,5659,206,13337,2011,May
2011-05,Oregon,28,8047,8145,0,16192,2011,May
2011-05,Pennsylvania,214,3,48124,0,48127,2011,May
2011-05,Puerto Rico,0,795,149,8,952,2011,May
2011-05,Rhode Island,0,625,471,8,1104,2011,May
2011-05,South Carolina,4838,4951,3294,70,8315,2011,May
2011-05,South Dakota,0,1464,2445,37,3946,2011,May
2011-05,Tennessee,12334,12655,7927,0,20582,2011,May
2011-05,Texas,17793,29323,24239,767,54329,2011,May
2011-05,Utah,150913,2268,3094,0,5362,2011,May
2011-05,Vermont,0,895,887,15,1797,2011,May
2011-05,Virgin Islands,82,27,3,0,30,2011,May
2011-05,Virginia,0,11938,8266,0,20204,2011,May
2011-05,Washington,8441,10296,8059,423,18778,2011,May
2011-05,West Virginia,0,4023,4109,58,8190,2011,May
2011-05,Wisconsin,0,6414,7485,141,14040,2011,May
2011-05,Wyoming,413,1435,1768,39,3242,2011,May
2011-04,Alabama,360,9332,8242,175,17749,2011,Apr
2011-04,Alaska,0,3008,3560,105,6673,2011,Apr
2011-04,Arizona,2354,9411,6361,273,16045,2011,Apr
2011-04,Arkansas,3239,4180,4296,67,8543,2011,Apr
2011-04,California,26912,30345,29788,0,60133,2011,Apr
2011-04,Colorado,0,12616,11577,0,24193,2011,Apr
2011-04,Connecticut,8726,4600,3579,116,8295,2011,Apr
2011-04,Delaware,0,898,738,21,1657,2011,Apr
2011-04,District of Columbia,0,36,1,0,37,2011,Apr
2011-04,Florida,0,30697,14985,0,45682,2011,Apr
2011-04,Georgia,7314,8447,6021,132,14600,2011,Apr
2011-04,Guam,0,17,22,2,41,2011,Apr
2011-04,Hawaii,1025,0,0,0,0,2011,Apr
2011-04,Idaho,1140,2434,4051,60,6545,2011,Apr
2011-04,Illinois,47216,11468,9467,0,20935,2011,Apr
2011-04,Indiana,8361,10938,9339,285,20562,2011,Apr
2011-04,Iowa,12477,59,2984,21,3064,2011,Apr
2011-04,Kansas,895,5097,4813,165,10075,2011,Apr
2011-04,Kentucky,164997,7336,7619,130,15085,2011,Apr
2011-04,Louisiana,0,7733,5914,150,13797,2011,Apr
2011-04,Maine,0,2459,2865,45,5369,2011,Apr
2011-04,Mariana Islands,0,0,0,0,0,2011,Apr
2011-04,Maryland,0,4226,4002,35,8263,2011,Apr
2011-04,Massachusetts,7030,4001,2211,97,6309,2011,Apr
2011-04,Michigan,20787,1640,10169,135,11944,2011,Apr
2011-04,Minnesota,12712,7478,11302,215,18995,2011,Apr
2011-04,Mississippi,392,4367,3689,64,8120,2011,Apr
2011-04,Missouri,2638,14435,11840,298,26573,2011,Apr
2011-04,Montana,796,2637,4230,49,6916,2011,Apr
2011-04,Nebraska,2758,144,1878,8,2030,2011,Apr
2011-04,Nevada,1440,4410,3383,0,7793,2011,Apr
2011-04,New Hampshire,1949,3045,2850,10,5905,2011,Apr
2011-04,New Jersey,0,2874,2363,0,5237,2011,Apr
2011-04,New Mexico,562,3988,3516,109,7613,2011,Apr
2011-04,New York,3068,6408,13721,375,20504,2011,Apr
2011-04,North Carolina,13480,295,8863,254,9412,2011,Apr
2011-04,North Dakota,416,1347,3022,20,4389,2011,Apr
2011-04,Ohio,0,21622,14325,472,36419,2011,Apr
2011-04,Oklahoma,0,9396,7599,351,17346,2011,Apr
2011-04,Oregon,46,8906,9231,0,18137,2011,Apr
2011-04,Pennsylvania,182,2,61720,0,61722,2011,Apr
2011-04,Puerto Rico,0,647,145,6,798,2011,Apr
2011-04,Rhode Island,0,835,617,19,1471,2011,Apr
2011-04,South Carolina,4135,6075,4063,87,10225,2011,Apr
2011-04,South Dakota,0,1880,3050,42,4972,2011,Apr
2011-04,Tennessee,10162,13983,9779,0,23762,2011,Apr
2011-04,Texas,18921,31570,25708,898,58176,2011,Apr
2011-04,Utah,100077,3009,3589,0,6598,2011,Apr
2011-04,Vermont,0,1039,1508,18,2565,2011,Apr
2011-04,Virgin Islands,73,16,1,0,17,2011,Apr
2011-04,Virginia,0,15008,10407,0,25415,2011,Apr
2011-04,Washington,9175,11843,9640,465,21948,2011,Apr
2011-04,West Virginia,0,5067,5560,103,10730,2011,Apr
2011-04,Wisconsin,0,7165,11960,196,19321,2011,Apr
2011-04,Wyoming,374,1650,1870,46,3566,2011,Apr
2011-03,Alabama,540,12176,10579,230,22985,2011,Mar
2011-03,Alaska,0,2654,3017,130,5801,2011,Mar
2011-03,Arizona,3106,11393,7362,337,19092,2011,Mar
2011-03,Arkansas,3205,6184,5909,85,12178,2011,Mar
2011-03,California,23865,29994,30323,0,60317,2011,Mar
2011-03,Colorado,32,14811,13223,0,28034,2011,Mar
2011-03,Connecticut,9954,5267,4147,83,9497,2011,Mar
2011-03,Delaware,0,1215,855,26,2096,2011,Mar
2011-03,District of Columbia,0,37,2,0,39,2011,Mar
2011-03,Florida,0,35962,17283,0,53245,2011,Mar
2011-03,Georgia,10943,12130,8096,144,20370,2011,Mar
2011-03,Guam,0,8,18,2,28,2011,Mar
2011-03,Hawaii,1224,0,0,0,0,2011,Mar
2011-03,Idaho,1164,3003,4379,77,7459,2011,Mar
2011-03,Illinois,53286,14745,12428,0,27173,2011,Mar
2011-03,Indiana,9796,15597,11489,468,27554,2011,Mar
2011-03,Iowa,20254,91,4095,22,4208,2011,Mar
2011-03,Kansas,908,7648,6940,218,14806,2011,Mar
2011-03,Kentucky,161429,9757,9133,139,19029,2011,Mar
2011-03,Louisiana,0,9488,7465,206,17159,2011,Mar
2011-03,Maine,0,2931,3350,76,6357,2011,Mar
2011-03,Mariana Islands,0,0,0,0,0,2011,Mar
2011-03,Maryland,167,5037,4274,32,9343,2011,Mar
2011-03,Massachusetts,8175,4439,2536,136,7111,2011,Mar
2011-03,Michigan,24973,1859,12837,145,14841,2011,Mar
2011-03,Minnesota,15131,7850,11543,239,19632,2011,Mar
2011-03,Mississippi,444,5510,5256,82,10848,2011,Mar
2011-03,Missouri,3227,18610,13979,393,32982,2011,Mar
2011-03,Montana,853,3072,4283,58,7413,2011,Mar
2011-03,Nebraska,3711,164,2463,19,2646,2011,Mar
2011-03,Nevada,1299,5549,4111,0,9660,2011,Mar
2011-03,New Hampshire,2464,3272,2586,17,5875,2011,Mar
2011-03,New Jersey,0,3052,2530,0,5582,2011,Mar
2011-03,New Mexico,653,4532,4054,148,8734,2011,Mar
2011-03,New York,3370,7472,14201,419,22092,2011,Mar
2011-03,North Carolina,19384,356,10789,240,11385,2011,Mar
2011-03,North Dakota,522,1473,2757,39,4269,2011,Mar
2011-03,Ohio,0,26107,16404,623,43134,2011,Mar
2011-03,Oklahoma,0,10439,8267,311,19017,2011,Mar
2011-03,Oregon,143,9969,10516,0,20485,2011,Mar
2011-03,Pennsylvania,231,0,71904,0,71904,2011,Mar
2011-03,Puerto Rico,0,753,158,9,920,2011,Mar
2011-03,Rhode Island,0,947,675,21,1643,2011,Mar
2011-03,South Carolina,6396,8202,5130,109,13441,2011,Mar
2011-03,South Dakota,0,2256,3395,46,5697,2011,Mar
2011-03,Tennessee,17760,18753,11979,0,30732,2011,Mar
2011-03,Texas,15224,39750,29342,972,70064,2011,Mar
2011-03,Utah,11941,3114,3983,0,7097,2011,Mar
2011-03,Vermont,0,1226,1538,28,2792,2011,Mar
2011-03,Virgin Islands,149,27,3,0,30,2011,Mar
2011-03,Virginia,0,18229,11780,0,30009,2011,Mar
2011-03,Washington,10373,14066,10800,598,25464,2011,Mar
2011-03,West Virginia,2,6516,6212,127,12855,2011,Mar
2011-03,Wisconsin,0,8867,13950,211,23028,2011,Mar
2011-03,Wyoming,571,2055,2079,37,4171,2011,Mar
2011-02,Alabama,429,13689,11452,147,25288,2011,Feb
2011-02,Alaska,0,2152,2213,73,4438,2011,Feb
2011-02,Arizona,2462,11824,6910,248,18982,2011,Feb
2011-02,Arkansas,1827,6696,6462,64,13222,2011,Feb
2011-02,California,19003,24348,24119,0,48467,2011,Feb
2011-02,Colorado,3,13470,11548,0,25018,2011,Feb
2011-02,Connecticut,7255,4386,3402,103,7891,2011,Feb
2011-02,Delaware,0,1011,794,33,1838,2011,Feb
2011-02,District of Columbia,0,31,2,0,33,2011,Feb
2011-02,Florida,1,37890,18121,0,56011,2011,Feb
2011-02,Georgia,9683,14936,9401,141,24478,2011,Feb
2011-02,Guam,0,18,21,2,41,2011,Feb
2011-02,Hawaii,887,0,0,0,0,2011,Feb
2011-02,Idaho,808,2623,3710,69,6402,2011,Feb
2011-02,Illinois,36379,11644,10778,0,22422,2011,Feb
2011-02,Indiana,6546,13991,9923,284,24198,2011,Feb
2011-02,Iowa,17566,98,3332,26,3456,2011,Feb
2011-02,Kansas,554,6796,6162,156,13114,2011,Feb
2011-02,Kentucky,159327,11819,10032,132,21983,2011,Feb
2011-02,Louisiana,0,10137,7948,141,18226,2011,Feb
2011-02,Maine,0,2162,2379,52,4593,2011,Feb
2011-02,Mariana Islands,0,0,0,0,0,2011,Feb
2011-02,Maryland,74,4183,4158,36,8377,2011,Feb
2011-02,Massachusetts,6290,3293,1637,70,5000,2011,Feb
2011-02,Michigan,18037,1541,9781,120,11442,2011,Feb
2011-02,Minnesota,9898,6272,8218,183,14673,2011,Feb
2011-02,Mississippi,377,6920,6109,105,13134,2011,Feb
2011-02,Missouri,1811,16363,12602,358,29323,2011,Feb
2011-02,Montana,705,2479,3348,45,5872,2011,Feb
2011-02,Nebraska,3161,117,2170,8,2295,2011,Feb
2011-02,Nevada,879,5043,3362,0,8405,2011,Feb
2011-02,New Hampshire,2283,2685,1941,8,4634,2011,Feb
2011-02,New Jersey,0,2467,1950,0,4417,2011,Feb
2011-02,New Mexico,525,4609,3979,113,8701,2011,Feb
2011-02,New York,2795,5940,11375,363,17678,2011,Feb
2011-02,North Carolina,18129,359,12774,279,13412,2011,Feb
2011-02,North Dakota,364,1268,2264,16,3548,2011,Feb
2011-02,Ohio,0,24197,14456,579,39232,2011,Feb
2011-02,Oklahoma,0,10419,8244,292,18955,2011,Feb
2011-02,Oregon,92,9061,9173,0,18234,2011,Feb
2011-02,Pennsylvania,184,0,59739,0,59739,2011,Feb
2011-02,Puerto Rico,0,587,120,4,711,2011,Feb
2011-02,Rhode Island,0,812,596,27,1435,2011,Feb
2011-02,South Carolina,4409,10531,5714,142,16387,2011,Feb
2011-02,South Dakota,0,1915,3108,34,5057,2011,Feb
2011-02,Tennessee,6072,21069,13707,0,34776,2011,Feb
2011-02,Texas,9592,41341,29888,868,72097,2011,Feb
2011-02,Utah,141674,2916,3402,0,6318,2011,Feb
2011-02,Vermont,0,1119,1150,20,2289,2011,Feb
2011-02,Virgin Islands,111,27,0,0,27,2011,Feb
2011-02,Virginia,0,19068,12222,0,31290,2011,Feb
2011-02,Washington,8759,12701,9663,442,22806,2011,Feb
2011-02,West Virginia,26,6537,6450,106,13093,2011,Feb
2011-02,Wisconsin,0,7023,9639,141,16803,2011,Feb
2011-02,Wyoming,415,1556,1908,27,3491,2011,Feb
2011-01,Alabama,423,10128,9747,158,20033,2011,Jan
2011-01,Alaska,0,1794,1892,75,3761,2011,Jan
2011-01,Arizona,2219,9310,6084,191,15585,2011,Jan
2011-01,Arkansas,1893,4545,5179,62,9786,2011,Jan
2011-01,California,22856,23418,22708,0,46126,2011,Jan
2011-01,Colorado,1243,11705,10191,0,21896,2011,Jan
2011-01,Connecticut,6065,3956,3241,50,7247,2011,Jan
2011-01,Delaware,0,845,646,20,1511,2011,Jan
2011-01,District of Columbia,0,17,0,0,17,2011,Jan
2011-01,Florida,0,32684,16731,0,49415,2011,Jan
2011-01,Georgia,7872,9240,7227,100,16567,2011,Jan
2011-01,Guam,0,21,21,2,44,2011,Jan
2011-01,Hawaii,870,0,0,0,0,2011,Jan
2011-01,Idaho,742,2023,3135,45,5203,2011,Jan
2011-01,Illinois,43982,10486,9844,0,20330,2011,Jan
2011-01,Indiana,8743,11783,8704,359,20846,2011,Jan
2011-01,Iowa,24976,86,3028,27,3141,2011,Jan
2011-01,Kansas,1352,5676,5696,146,11518,2011,Jan
2011-01,Kentucky,158538,7773,7003,116,14892,2011,Jan
2011-01,Louisiana,0,8332,9008,159,17499,2011,Jan
2011-01,Maine,0,1953,2308,74,4335,2011,Jan
2011-01,Mariana Islands,0,0,1,0,1,2011,Jan
2011-01,Maryland,40,3620,3639,29,7288,2011,Jan
2011-01,Massachusetts,6955,3305,1646,87,5038,2011,Jan
2011-01,Michigan,16863,1389,7927,103,9419,2011,Jan
2011-01,Minnesota,10907,5154,6960,129,12243,2011,Jan
2011-01,Mississippi,370,4208,5596,64,9868,2011,Jan
2011-01,Missouri,1868,14075,11247,270,25592,2011,Jan
2011-01,Montana,716,1850,2760,30,4640,2011,Jan
2011-01,Nebraska,3017,139,2296,10,2445,2011,Jan
2011-01,Nevada,888,4324,3067,0,7391,2011,Jan
2011-01,New Hampshire,2134,2597,1842,9,4448,2011,Jan
2011-01,New Jersey,0,2268,1759,0,4027,2011,Jan
2011-01,New Mexico,522,3527,3147,97,6771,2011,Jan
2011-01,New York,2596,5387,9811,304,15502,2011,Jan
2011-01,North Carolina,14564,297,9911,166,10374,2011,Jan
2011-01,North Dakota,278,930,2094,18,3042,2011,Jan
2011-01,Ohio,0,18305,11163,417,29885,2011,Jan
2011-01,Oklahoma,0,10078,7959,227,18264,2011,Jan
2011-01,Oregon,52,7234,7247,0,14481,2011,Jan
2011-01,Pennsylvania,505,0,48470,0,48470,2011,Jan
2011-01,Puerto Rico,0,623,110,12,745,2011,Jan
2011-01,Rhode Island,0,669,495,16,1180,2011,Jan
2011-01,South Carolina,3211,6022,4495,98,10615,2011,Jan
2011-01,South Dakota,0,1605,3000,33,4638,2011,Jan
2011-01,Tennessee,10749,15601,10436,0,26037,2011,Jan
2011-01,Texas,10252,34251,28911,774,63936,2011,Jan
2011-01,Utah,150498,2628,3024,0,5652,2011,Jan
2011-01,Vermont,0,800,822,19,1641,2011,Jan
2011-01,Virgin Islands,94,16,3,0,19,2011,Jan
2011-01,Virginia,0,13928,10089,0,24017,2011,Jan
2011-01,Washington,8362,10723,8083,421,19227,2011,Jan
2011-01,West Virginia,43,4288,4997,82,9367,2011,Jan
2011-01,Wisconsin,0,5558,7388,118,13064,2011,Jan
2011-01,Wyoming,430,1167,1414,32,2613,2011,Jan
2010-12,Alabama,413,13978,24298,152,38428,2010,Dec
2010-12,Alaska,0,2553,3950,93,6596,2010,Dec
2010-12,Arizona,2082,9943,9814,219,19976,2010,Dec
2010-12,Arkansas,2582,5816,12455,62,18333,2010,Dec
2010-12,California,24901,24519,32100,0,56619,2010,Dec
2010-12,Colorado,1381,13951,16894,0,30845,2010,Dec
2010-12,Connecticut,6791,4371,4349,32,8752,2010,Dec
2010-12,Delaware,0,1003,1355,20,2378,2010,Dec
2010-12,District of Columbia,0,25,2,0,27,2010,Dec
2010-12,Florida,30,34196,27204,0,61400,2010,Dec
2010-12,Georgia,6922,12171,18708,122,31001,2010,Dec
2010-12,Guam,0,25,20,1,46,2010,Dec
2010-12,Hawaii,933,0,0,0,0,2010,Dec
2010-12,Idaho,562,2652,5717,61,8430,2010,Dec
2010-12,Illinois,42861,11217,14646,0,25863,2010,Dec
2010-12,Indiana,8506,11672,15692,236,27600,2010,Dec
2010-12,Iowa,9804,76,6065,16,6157,2010,Dec
2010-12,Kansas,1297,6722,10496,126,17344,2010,Dec
2010-12,Kentucky,157541,10109,16321,103,26533,2010,Dec
2010-12,Louisiana,0,10731,22440,135,33306,2010,Dec
2010-12,Maine,0,2281,4165,40,6486,2010,Dec
2010-12,Mariana Islands,0,0,0,0,0,2010,Dec
2010-12,Maryland,0,3425,6020,21,9466,2010,Dec
2010-12,Massachusetts,6103,3378,2213,89,5680,2010,Dec
2010-12,Michigan,15596,1559,14969,104,16632,2010,Dec
2010-12,Minnesota,9201,5236,11147,145,16528,2010,Dec
2010-12,Mississippi,322,5900,17019,98,23017,2010,Dec
2010-12,Missouri,1549,15736,19623,270,35629,2010,Dec
2010-12,Montana,518,2666,5315,38,8019,2010,Dec
2010-12,Nebraska,2877,172,4618,15,4805,2010,Dec
2010-12,Nevada,1158,5046,4759,0,9805,2010,Dec
2010-12,New Hampshire,2432,2809,2747,15,5571,2010,Dec
2010-12,New Jersey,0,2004,2778,0,4782,2010,Dec
2010-12,New Mexico,501,4431,5658,98,10187,2010,Dec
2010-12,New York,2606,5392,16569,285,22246,2010,Dec
2010-12,North Carolina,12712,361,22141,178,22680,2010,Dec
2010-12,North Dakota,154,984,3091,16,4091,2010,Dec
2010-12,Ohio,0,21429,22061,375,43865,2010,Dec
2010-12,Oklahoma,0,11050,14617,232,25899,2010,Dec
2010-12,Oregon,48,8088,12091,0,20179,2010,Dec
2010-12,Pennsylvania,188,0,63195,0,63195,2010,Dec
2010-12,Puerto Rico,0,656,130,3,789,2010,Dec
2010-12,Rhode Island,0,746,606,16,1368,2010,Dec
2010-12,South Carolina,3214,7545,11109,108,18762,2010,Dec
2010-12,South Dakota,0,1826,4931,26,6783,2010,Dec
2010-12,Tennessee,9484,18915,22001,0,40916,2010,Dec
2010-12,Texas,10633,43197,60696,728,104621,2010,Dec
2010-12,Utah,25888,3663,6960,0,10623,2010,Dec
2010-12,Vermont,0,916,1391,10,2317,2010,Dec
2010-12,Virgin Islands,111,21,0,0,21,2010,Dec
2010-12,Virginia,0,14577,17746,0,32323,2010,Dec
2010-12,Washington,6632,12032,12873,366,25271,2010,Dec
2010-12,West Virginia,31,5752,10146,91,15989,2010,Dec
2010-12,Wisconsin,0,5978,11367,123,17468,2010,Dec
2010-12,Wyoming,330,1783,2838,24,4645,2010,Dec
2010-11,Alabama,381,9943,17513,122,27578,2010,Nov
2010-11,Alaska,0,1783,2776,80,4639,2010,Nov
2010-11,Arizona,1978,7006,6547,171,13724,2010,Nov
2010-11,Arkansas,1971,3899,10722,57,14678,2010,Nov
2010-11,California,20531,18478,24984,0,43462,2010,Nov
2010-11,Colorado,1942,9975,12773,0,22748,2010,Nov
2010-11,Connecticut,7102,3878,3972,48,7898,2010,Nov
2010-11,Delaware,0,805,1212,15,2032,2010,Nov
2010-11,District of Columbia,0,21,0,0,21,2010,Nov
2010-11,Florida,0,27691,19404,0,47095,2010,Nov
2010-11,Georgia,6046,7602,11566,93,19261,2010,Nov
2010-11,Guam,0,18,22,1,41,2010,Nov
2010-11,Hawaii,800,0,0,0,0,2010,Nov
2010-11,Idaho,572,1692,3661,29,5382,2010,Nov
2010-11,Illinois,40322,9128,13938,0,23066,2010,Nov
2010-11,Indiana,7193,8862,14956,185,24003,2010,Nov
2010-11,Iowa,6884,40,6199,10,6249,2010,Nov
2010-11,Kansas,877,4980,8773,106,13859,2010,Nov
2010-11,Kentucky,156871,6776,13152,91,20019,2010,Nov
2010-11,Louisiana,0,7413,16069,108,23590,2010,Nov
2010-11,Maine,0,1855,3824,34,5713,2010,Nov
2010-11,Mariana Islands,0,0,0,0,0,2010,Nov
2010-11,Maryland,0,3175,6327,23,9525,2010,Nov
2010-11,Massachusetts,6635,2569,2280,49,4898,2010,Nov
2010-11,Michigan,14220,1303,17554,88,18945,2010,Nov
2010-11,Minnesota,6948,4196,11475,100,15771,2010,Nov
2010-11,Mississippi,294,4088,13772,114,17974,2010,Nov
2010-11,Missouri,1567,11684,17214,240,29138,2010,Nov
2010-11,Montana,477,1767,3879,20,5666,2010,Nov
2010-11,Nebraska,2516,91,3930,14,4035,2010,Nov
2010-11,Nevada,1258,3774,3365,0,7139,2010,Nov
2010-11,New Hampshire,1856,2412,2639,10,5061,2010,Nov
2010-11,New Jersey,0,2102,2903,0,5005,2010,Nov
2010-11,New Mexico,431,3186,3819,70,7075,2010,Nov
2010-11,New York,2263,4811,18366,218,23395,2010,Nov
2010-11,North Carolina,11839,275,16136,158,16569,2010,Nov
2010-11,North Dakota,361,792,3071,13,3876,2010,Nov
2010-11,Ohio,0,16886,22161,333,39380,2010,Nov
2010-11,Oklahoma,0,8321,11041,262,19624,2010,Nov
2010-11,Oregon,25,5850,8826,0,14676,2010,Nov
2010-11,Pennsylvania,204,1,67043,0,67044,2010,Nov
2010-11,Puerto Rico,0,542,102,2,646,2010,Nov
2010-11,Rhode Island,0,652,570,16,1238,2010,Nov
2010-11,South Carolina,2972,7017,8934,96,16047,2010,Nov
2010-11,South Dakota,0,1312,4787,25,6124,2010,Nov
2010-11,Tennessee,6200,14304,17217,0,31521,2010,Nov
2010-11,Texas,11360,31451,40228,614,72293,2010,Nov
2010-11,Utah,10349,2500,4273,0,6773,2010,Nov
2010-11,Vermont,0,629,1615,26,2270,2010,Nov
2010-11,Virgin Islands,105,14,1,0,15,2010,Nov
2010-11,Virginia,0,12715,16299,0,29014,2010,Nov
2010-11,Washington,5720,9230,8812,272,18314,2010,Nov
2010-11,West Virginia,3,3991,10722,59,14772,2010,Nov
2010-11,Wisconsin,0,5242,15123,122,20487,2010,Nov
2010-11,Wyoming,281,1082,1911,23,3016,2010,Nov
2010-10,Alabama,398,8410,12198,108,20716,2010,Oct
2010-10,Alaska,0,2399,3513,88,6000,2010,Oct
2010-10,Arizona,2021,7142,5384,159,12685,2010,Oct
2010-10,Arkansas,1885,3462,7811,55,11328,2010,Oct
2010-10,California,25131,21351,22352,0,43703,2010,Oct
2010-10,Colorado,2141,10017,11714,0,21731,2010,Oct
2010-10,Connecticut,6695,3782,3840,33,7655,2010,Oct
2010-10,Delaware,0,735,947,10,1692,2010,Oct
2010-10,District of Columbia,0,25,1,0,26,2010,Oct
2010-10,Florida,0,26902,15965,0,42867,2010,Oct
2010-10,Georgia,6742,7606,10062,87,17755,2010,Oct
2010-10,Guam,0,14,25,2,41,2010,Oct
2010-10,Hawaii,910,0,0,0,0,2010,Oct
2010-10,Idaho,708,1798,4213,31,6042,2010,Oct
2010-10,Illinois,42642,8918,10462,0,19380,2010,Oct
2010-10,Indiana,8025,9477,11402,240,21119,2010,Oct
2010-10,Iowa,6529,42,4289,8,4339,2010,Oct
2010-10,Kansas,1304,4950,6760,114,11824,2010,Oct
2010-10,Kentucky,155870,6796,9734,93,16623,2010,Oct
2010-10,Louisiana,0,6792,14282,121,21195,2010,Oct
2010-10,Maine,0,2141,5938,33,8112,2010,Oct
2010-10,Mariana Islands,0,0,0,0,0,2010,Oct
2010-10,Maryland,3,2997,4430,18,7445,2010,Oct
2010-10,Massachusetts,7187,2805,2099,49,4953,2010,Oct
2010-10,Michigan,15050,1301,13893,111,15305,2010,Oct
2010-10,Minnesota,9353,5018,17640,119,22777,2010,Oct
2010-10,Mississippi,291,3761,8297,89,12147,2010,Oct
2010-10,Missouri,1864,11534,15056,215,26805,2010,Oct
2010-10,Montana,621,1902,5855,38,7795,2010,Oct
2010-10,Nebraska,2430,89,3338,10,3437,2010,Oct
2010-10,Nevada,836,3529,2744,0,6273,2010,Oct
2010-10,New Hampshire,1847,2570,3131,15,5716,2010,Oct
2010-10,New Jersey,0,2122,2223,0,4345,2010,Oct
2010-10,New Mexico,593,3322,3385,78,6785,2010,Oct
2010-10,New York,2954,5056,16813,219,22088,2010,Oct
2010-10,North Carolina,11691,230,11897,169,12296,2010,Oct
2010-10,North Dakota,328,879,4913,21,5813,2010,Oct
2010-10,Ohio,0,16955,14932,390,32277,2010,Oct
2010-10,Oklahoma,0,6962,8168,172,15302,2010,Oct
2010-10,Oregon,43,6053,8402,0,14455,2010,Oct
2010-10,Pennsylvania,545,1,56795,0,56796,2010,Oct
2010-10,Puerto Rico,0,494,88,1,583,2010,Oct
2010-10,Rhode Island,0,625,578,22,1225,2010,Oct
2010-10,South Carolina,2852,4512,5403,73,9988,2010,Oct
2010-10,South Dakota,0,1360,6299,21,7680,2010,Oct
2010-10,Tennessee,9016,12943,12387,0,25330,2010,Oct
2010-10,Texas,19990,25858,33053,565,59476,2010,Oct
2010-10,Utah,148942,1995,3593,0,5588,2010,Oct
2010-10,Vermont,0,776,1757,18,2551,2010,Oct
2010-10,Virgin Islands,88,21,2,0,23,2010,Oct
2010-10,Virginia,0,12655,12674,0,25329,2010,Oct
2010-10,Washington,7211,9138,9407,315,18860,2010,Oct
2010-10,West Virginia,28,4156,8515,57,12728,2010,Oct
2010-10,Wisconsin,0,5887,15155,121,21163,2010,Oct
2010-10,Wyoming,567,938,1922,14,2874,2010,Oct
2010-09,Alabama,334,8294,10525,124,18943,2010,Sep
2010-09,Alaska,0,1767,2840,60,4667,2010,Sep
2010-09,Arizona,2018,7342,5704,133,13179,2010,Sep
2010-09,Arkansas,2421,3619,6236,57,9912,2010,Sep
2010-09,California,21810,18221,20434,0,38655,2010,Sep
2010-09,Colorado,1580,9991,10435,0,20426,2010,Sep
2010-09,Connecticut,6692,3678,3328,37,7043,2010,Sep
2010-09,Delaware,0,717,808,18,1543,2010,Sep
2010-09,District of Columbia,0,27,1,0,28,2010,Sep
2010-09,Florida,1,25405,13802,0,39207,2010,Sep
2010-09,Georgia,6189,6953,7373,93,14419,2010,Sep
2010-09,Guam,0,17,23,0,40,2010,Sep
2010-09,Hawaii,873,0,0,0,0,2010,Sep
2010-09,Idaho,707,1886,4020,37,5943,2010,Sep
2010-09,Illinois,40568,8469,9115,0,17584,2010,Sep
2010-09,Indiana,9235,8301,8792,167,17260,2010,Sep
2010-09,Iowa,6080,35,3312,11,3358,2010,Sep
2010-09,Kansas,526,4118,5348,89,9555,2010,Sep
2010-09,Kentucky,153331,6340,7758,78,14176,2010,Sep
2010-09,Louisiana,0,8185,13822,155,22162,2010,Sep
2010-09,Maine,0,2072,4309,45,6426,2010,Sep
2010-09,Mariana Islands,0,0,0,0,0,2010,Sep
2010-09,Maryland,0,2859,3701,14,6574,2010,Sep
2010-09,Massachusetts,6323,2501,1839,71,4411,2010,Sep
2010-09,Michigan,15398,1213,12889,118,14220,2010,Sep
2010-09,Minnesota,10127,4832,15363,116,20311,2010,Sep
2010-09,Mississippi,329,3556,6433,56,10045,2010,Sep
2010-09,Missouri,1613,11250,11432,194,22876,2010,Sep
2010-09,Montana,677,2109,4679,23,6811,2010,Sep
2010-09,Nebraska,2128,65,2418,6,2489,2010,Sep
2010-09,Nevada,1084,3393,2757,0,6150,2010,Sep
2010-09,New Hampshire,2026,2321,2615,8,4944,2010,Sep
2010-09,New Jersey,0,2033,1972,0,4005,2010,Sep
2010-09,New Mexico,817,3302,3324,69,6695,2010,Sep
2010-09,New York,2377,4967,14319,274,19560,2010,Sep
2010-09,North Carolina,12189,207,9925,162,10294,2010,Sep
2010-09,North Dakota,338,818,3270,16,4104,2010,Sep
2010-09,Ohio,0,14875,12466,296,27637,2010,Sep
2010-09,Oklahoma,0,6721,6944,166,13831,2010,Sep
2010-09,Oregon,25,6389,9154,0,15543,2010,Sep
2010-09,Pennsylvania,173,0,51739,0,51739,2010,Sep
2010-09,Puerto Rico,0,520,169,4,693,2010,Sep
2010-09,Rhode Island,0,588,506,6,1100,2010,Sep
2010-09,South Carolina,3600,4892,5055,53,10000,2010,Sep
2010-09,South Dakota,0,1362,4227,20,5609,2010,Sep
2010-09,Tennessee,8508,12033,10387,0,22420,2010,Sep
2010-09,Texas,8238,24093,34038,529,58660,2010,Sep
2010-09,Utah,32826,2045,3423,0,5468,2010,Sep
2010-09,Vermont,0,849,1451,11,2311,2010,Sep
2010-09,Virgin Islands,121,32,4,0,36,2010,Sep
2010-09,Virginia,0,11106,10776,0,21882,2010,Sep
2010-09,Washington,7721,8816,9005,284,18105,2010,Sep
2010-09,West Virginia,9,3630,6102,48,9780,2010,Sep
2010-09,Wisconsin,0,5199,12920,120,18239,2010,Sep
2010-09,Wyoming,558,1120,2036,21,3177,2010,Sep
2010-08,Alabama,383,9180,10361,142,19683,2010,Aug
2010-08,Alaska,0,1998,3168,67,5233,2010,Aug
2010-08,Arizona,2045,7333,5615,147,13095,2010,Aug
2010-08,Arkansas,2934,3431,4670,50,8151,2010,Aug
2010-08,California,24503,18686,22110,0,40796,2010,Aug
2010-08,Colorado,1478,11216,10872,0,22088,2010,Aug
2010-08,Connecticut,7107,3786,3259,28,7073,2010,Aug
2010-08,Delaware,0,698,687,19,1404,2010,Aug
2010-08,District of Columbia,0,21,0,0,21,2010,Aug
2010-08,Florida,1,25610,13532,0,39142,2010,Aug
2010-08,Georgia,6842,7000,6602,85,13687,2010,Aug
2010-08,Guam,0,25,19,4,48,2010,Aug
2010-08,Hawaii,874,0,0,0,0,2010,Aug
2010-08,Idaho,651,1763,3249,23,5035,2010,Aug
2010-08,Illinois,41787,8621,8960,0,17581,2010,Aug
2010-08,Indiana,9850,9467,8859,218,18544,2010,Aug
2010-08,Iowa,5056,40,2496,6,2542,2010,Aug
2010-08,Kansas,4,4222,4949,108,9279,2010,Aug
2010-08,Kentucky,164916,5882,6494,75,12451,2010,Aug
2010-08,Louisiana,0,7036,9750,111,16897,2010,Aug
2010-08,Maine,0,1751,3005,45,4801,2010,Aug
2010-08,Mariana Islands,0,0,0,0,0,2010,Aug
2010-08,Maryland,1,3378,3256,13,6647,2010,Aug
2010-08,Massachusetts,5025,2805,1673,62,4540,2010,Aug
2010-08,Michigan,14887,1266,9877,93,11236,2010,Aug
2010-08,Minnesota,8807,4782,10143,97,15022,2010,Aug
2010-08,Mississippi,286,3999,5824,71,9894,2010,Aug
2010-08,Missouri,1946,11357,10602,211,22170,2010,Aug
2010-08,Montana,627,2443,3940,50,6433,2010,Aug
2010-08,Nebraska,1939,51,2127,10,2188,2010,Aug
2010-08,Nevada,1045,3608,2911,0,6519,2010,Aug
2010-08,New Hampshire,1768,2247,2050,11,4308,2010,Aug
2010-08,New Jersey,0,1975,1746,0,3721,2010,Aug
2010-08,New Mexico,989,3488,3155,96,6739,2010,Aug
2010-08,New York,2744,4713,10271,182,15166,2010,Aug
2010-08,North Carolina,13321,223,9248,169,9640,2010,Aug
2010-08,North Dakota,239,805,2342,14,3161,2010,Aug
2010-08,Ohio,0,14235,11330,380,25945,2010,Aug
2010-08,Oklahoma,0,7200,6992,161,14353,2010,Aug
2010-08,Oregon,28,6148,6995,0,13143,2010,Aug
2010-08,Pennsylvania,159,0,47082,0,47082,2010,Aug
2010-08,Puerto Rico,0,556,167,4,727,2010,Aug
2010-08,Rhode Island,0,586,479,19,1084,2010,Aug
2010-08,South Carolina,4549,4466,4578,55,9099,2010,Aug
2010-08,South Dakota,0,1270,3064,13,4347,2010,Aug
2010-08,Tennessee,7305,12546,10049,0,22595,2010,Aug
2010-08,Texas,13656,25618,30875,598,57091,2010,Aug
2010-08,Utah,8398,1873,2778,0,4651,2010,Aug
2010-08,Vermont,0,693,964,8,1665,2010,Aug
2010-08,Virgin Islands,131,19,1,0,20,2010,Aug
2010-08,Virginia,0,11857,10207,0,22064,2010,Aug
2010-08,Washington,6587,9030,7578,276,16884,2010,Aug
2010-08,West Virginia,1,3601,4766,41,8408,2010,Aug
2010-08,Wisconsin,0,5110,9711,94,14915,2010,Aug
2010-08,Wyoming,520,1160,1636,16,2812,2010,Aug
2010-07,Alabama,363,8451,7714,135,16300,2010,Jul
2010-07,Alaska,0,2193,2355,44,4592,2010,Jul
2010-07,Arizona,1789,6933,4405,177,11515,2010,Jul
2010-07,Arkansas,2526,3377,3587,60,7024,2010,Jul
2010-07,California,24115,19019,19505,0,38524,2010,Jul
2010-07,Colorado,1727,9883,8632,0,18515,2010,Jul
2010-07,Connecticut,6785,3522,2507,32,6061,2010,Jul
2010-07,Delaware,0,680,557,14,1251,2010,Jul
2010-07,District of Columbia,1,31,0,0,31,2010,Jul
2010-07,Florida,0,25729,12007,0,37736,2010,Jul
2010-07,Georgia,7185,6734,4676,99,11509,2010,Jul
2010-07,Guam,0,20,20,2,42,2010,Jul
2010-07,Hawaii,783,0,0,0,0,2010,Jul
2010-07,Idaho,784,1638,2511,44,4193,2010,Jul
2010-07,Illinois,34727,7950,6957,0,14907,2010,Jul
2010-07,Indiana,9258,7672,6279,150,14101,2010,Jul
2010-07,Iowa,5048,50,1700,5,1755,2010,Jul
2010-07,Kansas,0,3951,3402,83,7436,2010,Jul
2010-07,Kentucky,204102,5885,5426,93,11404,2010,Jul
2010-07,Louisiana,0,6805,6112,142,13059,2010,Jul
2010-07,Maine,0,1583,2207,33,3823,2010,Jul
2010-07,Mariana Islands,0,0,0,0,0,2010,Jul
2010-07,Maryland,0,3147,2703,16,5866,2010,Jul
2010-07,Massachusetts,3789,2412,1491,69,3972,2010,Jul
2010-07,Michigan,13411,1264,6504,82,7850,2010,Jul
2010-07,Minnesota,8077,4091,6283,100,10474,2010,Jul
2010-07,Mississippi,307,3685,3750,57,7492,2010,Jul
2010-07,Missouri,1853,10845,7545,208,18598,2010,Jul
2010-07,Montana,563,1957,2960,36,4953,2010,Jul
2010-07,Nebraska,1729,79,1348,5,1432,2010,Jul
2010-07,Nevada,1194,3329,2336,0,5665,2010,Jul
2010-07,New Hampshire,1393,2152,2137,8,4297,2010,Jul
2010-07,New Jersey,0,2107,1547,0,3654,2010,Jul
2010-07,New Mexico,1597,3225,2778,64,6067,2010,Jul
2010-07,New York,2162,4496,8367,162,13025,2010,Jul
2010-07,North Carolina,11000,240,7092,152,7484,2010,Jul
2010-07,North Dakota,208,676,1728,12,2416,2010,Jul
2010-07,Ohio,0,14141,9700,291,24132,2010,Jul
2010-07,Oklahoma,0,6836,5338,159,12333,2010,Jul
2010-07,Oregon,11,5966,5944,0,11910,2010,Jul
2010-07,Pennsylvania,253,2,42637,0,42639,2010,Jul
2010-07,Puerto Rico,0,561,151,1,713,2010,Jul
2010-07,Rhode Island,0,543,375,18,936,2010,Jul
2010-07,South Carolina,3977,4637,3180,51,7868,2010,Jul
2010-07,South Dakota,0,1185,2234,17,3436,2010,Jul
2010-07,Tennessee,6529,12405,8038,0,20443,2010,Jul
2010-07,Texas,9270,25133,21903,559,47595,2010,Jul
2010-07,Utah,61482,1906,2291,0,4197,2010,Jul
2010-07,Vermont,0,680,800,22,1502,2010,Jul
2010-07,Virgin Islands,172,16,2,0,18,2010,Jul
2010-07,Virginia,0,12207,8592,0,20799,2010,Jul
2010-07,Washington,6085,8360,6550,280,15190,2010,Jul
2010-07,West Virginia,10,3387,3690,55,7132,2010,Jul
2010-07,Wisconsin,0,4188,6434,67,10689,2010,Jul
2010-07,Wyoming,496,1023,1294,13,2330,2010,Jul
2010-06,Alabama,352,8251,6608,153,15012,2010,Jun
2010-06,Alaska,0,2316,2236,64,4616,2010,Jun
2010-06,Arizona,1632,6144,4484,167,10795,2010,Jun
2010-06,Arkansas,3561,3409,3134,33,6576,2010,Jun
2010-06,California,25276,17778,18802,0,36580,2010,Jun
2010-06,Colorado,1289,9795,8378,0,18173,2010,Jun
2010-06,Connecticut,7753,3644,2989,29,6662,2010,Jun
2010-06,Delaware,0,645,524,19,1188,2010,Jun
2010-06,District of Columbia,0,19,2,0,21,2010,Jun
2010-06,Florida,0,24424,11565,0,35989,2010,Jun
2010-06,Georgia,7720,6093,4332,87,10512,2010,Jun
2010-06,Guam,0,12,16,0,28,2010,Jun
2010-06,Hawaii,895,0,0,0,0,2010,Jun
2010-06,Idaho,1134,1681,2762,28,4471,2010,Jun
2010-06,Illinois,37457,7818,6701,1,14520,2010,Jun
2010-06,Indiana,10706,7950,6307,228,14485,2010,Jun
2010-06,Iowa,5742,54,1938,9,2001,2010,Jun
2010-06,Kansas,0,3638,3443,91,7172,2010,Jun
2010-06,Kentucky,202592,5223,4634,90,9947,2010,Jun
2010-06,Louisiana,0,6170,5091,131,11392,2010,Jun
2010-06,Maine,0,1796,2188,28,4012,2010,Jun
2010-06,Mariana Islands,0,0,0,0,0,2010,Jun
2010-06,Maryland,0,2898,2663,16,5577,2010,Jun
2010-06,Massachusetts,3951,2387,1464,80,3931,2010,Jun
2010-06,Michigan,14411,1312,6790,98,8200,2010,Jun
2010-06,Minnesota,9446,4255,6687,96,11038,2010,Jun
2010-06,Mississippi,338,3282,3117,57,6456,2010,Jun
2010-06,Missouri,2167,11293,7782,200,19275,2010,Jun
2010-06,Montana,610,1979,3358,43,5380,2010,Jun
2010-06,Nebraska,1978,66,1473,8,1547,2010,Jun
2010-06,Nevada,1043,3399,2595,0,5994,2010,Jun
2010-06,New Hampshire,1666,2075,1890,14,3979,2010,Jun
2010-06,New Jersey,0,2159,1552,0,3711,2010,Jun
2010-06,New Mexico,716,3141,2767,71,5979,2010,Jun
2010-06,New York,2512,5010,8535,212,13757,2010,Jun
2010-06,North Carolina,10766,226,6657,166,7049,2010,Jun
2010-06,North Dakota,518,686,1741,16,2443,2010,Jun
2010-06,Ohio,0,12808,8904,259,21971,2010,Jun
2010-06,Oklahoma,0,6406,4550,158,11114,2010,Jun
2010-06,Oregon,20,6223,6549,0,12772,2010,Jun
2010-06,Pennsylvania,157,0,42880,0,42880,2010,Jun
2010-06,Puerto Rico,0,504,127,4,635,2010,Jun
2010-06,Rhode Island,0,531,433,15,979,2010,Jun
2010-06,South Carolina,5660,4560,2818,49,7427,2010,Jun
2010-06,South Dakota,0,1177,2174,15,3366,2010,Jun
2010-06,Tennessee,7089,11699,6858,0,18557,2010,Jun
2010-06,Texas,6675,24420,19503,549,44472,2010,Jun
2010-06,Utah,12848,1910,2565,0,4475,2010,Jun
2010-06,Vermont,0,684,716,8,1408,2010,Jun
2010-06,Virgin Islands,137,18,1,0,19,2010,Jun
2010-06,Virginia,0,9347,6917,0,16264,2010,Jun
2010-06,Washington,5811,9015,7126,274,16415,2010,Jun
2010-06,West Virginia,60,3599,3615,64,7278,2010,Jun
2010-06,Wisconsin,0,4254,6869,89,11212,2010,Jun
2010-06,Wyoming,666,1156,1439,18,2613,2010,Jun
2010-05,Alabama,336,8028,6946,150,15124,2010,May
2010-05,Alaska,0,2298,2552,39,4889,2010,May
2010-05,Arizona,1417,7261,4744,143,12148,2010,May
2010-05,Arkansas,2477,3353,3225,41,6619,2010,May
2010-05,California,28855,19464,20997,0,40461,2010,May
2010-05,Colorado,1390,10056,8534,0,18590,2010,May
2010-05,Connecticut,7571,3574,2706,34,6314,2010,May
2010-05,Delaware,0,640,541,20,1201,2010,May
2010-05,District of Columbia,0,24,1,0,25,2010,May
2010-05,Florida,1,25428,11640,0,37068,2010,May
2010-05,Georgia,7742,6477,4553,74,11104,2010,May
2010-05,Guam,0,23,22,1,46,2010,May
2010-05,Hawaii,787,0,0,0,0,2010,May
2010-05,Idaho,1298,1868,2970,39,4877,2010,May
2010-05,Illinois,29322,8304,7071,0,15375,2010,May
2010-05,Indiana,10016,7761,6257,216,14234,2010,May
2010-05,Iowa,5685,44,1732,12,1788,2010,May
2010-05,Kansas,0,3782,3634,102,7518,2010,May
2010-05,Kentucky,199991,5486,5056,79,10621,2010,May
2010-05,Louisiana,0,6047,4511,146,10704,2010,May
2010-05,Maine,0,1685,2206,32,3923,2010,May
2010-05,Mariana Islands,0,0,0,0,0,2010,May
2010-05,Maryland,0,3220,2724,16,5960,2010,May
2010-05,Massachusetts,3822,2501,1443,79,4023,2010,May
2010-05,Michigan,15675,1552,7455,115,9122,2010,May
2010-05,Minnesota,8515,4672,6238,112,11022,2010,May
2010-05,Mississippi,291,3540,3054,71,6665,2010,May
2010-05,Missouri,2360,10851,7698,194,18743,2010,May
2010-05,Montana,650,1977,3426,44,5447,2010,May
2010-05,Nebraska,2000,100,1387,4,1491,2010,May
2010-05,Nevada,1247,3919,2883,0,6802,2010,May
2010-05,New Hampshire,1787,2021,1857,16,3894,2010,May
2010-05,New Jersey,0,2189,1646,0,3835,2010,May
2010-05,New Mexico,486,3385,2792,92,6269,2010,May
2010-05,New York,1955,4774,8957,224,13955,2010,May
2010-05,North Carolina,10430,206,7040,150,7396,2010,May
2010-05,North Dakota,478,744,1874,20,2638,2010,May
2010-05,Ohio,0,14214,9410,332,23956,2010,May
2010-05,Oklahoma,0,7131,4952,160,12243,2010,May
2010-05,Oregon,11,6477,7125,0,13602,2010,May
2010-05,Pennsylvania,178,0,41483,0,41483,2010,May
2010-05,Puerto Rico,0,491,109,2,602,2010,May
2010-05,Rhode Island,0,569,393,23,985,2010,May
2010-05,South Carolina,4710,4641,2845,58,7544,2010,May
2010-05,South Dakota,0,1309,2218,33,3560,2010,May
2010-05,Tennessee,4639,11886,6961,0,18847,2010,May
2010-05,Texas,8015,24476,19923,557,44956,2010,May
2010-05,Utah,13326,2192,2682,0,4874,2010,May
2010-05,Vermont,0,761,826,16,1603,2010,May
2010-05,Virgin Islands,70,11,5,0,16,2010,May
2010-05,Virginia,0,15652,11525,0,27177,2010,May
2010-05,Washington,5904,9214,7521,321,17056,2010,May
2010-05,West Virginia,1,3498,3594,36,7128,2010,May
2010-05,Wisconsin,0,4439,6821,105,11365,2010,May
2010-05,Wyoming,617,1193,1687,42,2922,2010,May
2010-04,Alabama,396,8727,8095,131,16953,2010,Apr
2010-04,Alaska,0,2650,3136,64,5850,2010,Apr
2010-04,Arizona,1905,7787,5097,198,13082,2010,Apr
2010-04,Arkansas,4303,3865,3833,45,7743,2010,Apr
2010-04,California,26930,26170,27650,0,53820,2010,Apr
2010-04,Colorado,0,10998,9403,0,20401,2010,Apr
2010-04,Connecticut,8726,3994,3098,97,7189,2010,Apr
2010-04,Delaware,0,772,626,17,1415,2010,Apr
2010-04,District of Columbia,0,29,1,0,30,2010,Apr
2010-04,Florida,1,26817,12952,0,39769,2010,Apr
2010-04,Georgia,9061,7215,4897,95,12207,2010,Apr
2010-04,Guam,0,13,19,2,34,2010,Apr
2010-04,Hawaii,963,0,0,0,0,2010,Apr
2010-04,Idaho,1723,1982,3133,44,5159,2010,Apr
2010-04,Illinois,36904,8557,8005,0,16562,2010,Apr
2010-04,Indiana,8696,8149,7473,227,15849,2010,Apr
2010-04,Iowa,7121,37,2442,13,2492,2010,Apr
2010-04,Kansas,0,4268,4182,107,8557,2010,Apr
2010-04,Kentucky,194706,6274,6352,104,12730,2010,Apr
2010-04,Louisiana,0,6363,4992,114,11469,2010,Apr
2010-04,Maine,0,2078,2575,49,4702,2010,Apr
2010-04,Mariana Islands,0,0,0,0,0,2010,Apr
2010-04,Maryland,0,3671,3136,17,6824,2010,Apr
2010-04,Massachusetts,4027,2791,1778,71,4640,2010,Apr
2010-04,Michigan,18361,1636,8860,143,10639,2010,Apr
2010-04,Minnesota,10913,5514,9001,141,14656,2010,Apr
2010-04,Mississippi,325,3883,3256,59,7198,2010,Apr
2010-04,Missouri,2635,11550,9599,199,21348,2010,Apr
2010-04,Montana,906,2172,3824,65,6061,2010,Apr
2010-04,Nebraska,2305,87,1637,5,1729,2010,Apr
2010-04,Nevada,1187,4284,3138,0,7422,2010,Apr
2010-04,New Hampshire,1886,2592,2392,17,5001,2010,Apr
2010-04,New Jersey,0,2322,1820,0,4142,2010,Apr
2010-04,New Mexico,698,3469,3251,75,6795,2010,Apr
2010-04,New York,2670,5313,11554,270,17137,2010,Apr
2010-04,North Carolina,12280,203,7514,169,7886,2010,Apr
2010-04,North Dakota,608,888,2004,16,2908,2010,Apr
2010-04,Ohio,1,17333,11342,329,29004,2010,Apr
2010-04,Oklahoma,0,8038,6220,235,14493,2010,Apr
2010-04,Oregon,35,7445,8065,0,15510,2010,Apr
2010-04,Pennsylvania,211,1,49644,0,49645,2010,Apr
2010-04,Puerto Rico,0,530,104,1,635,2010,Apr
2010-04,Rhode Island,0,633,483,19,1135,2010,Apr
2010-04,South Carolina,4330,5313,3336,60,8709,2010,Apr
2010-04,South Dakota,0,1396,2785,19,4200,2010,Apr
2010-04,Tennessee,9391,12533,8066,0,20599,2010,Apr
2010-04,Texas,9221,24481,21343,595,46419,2010,Apr
2010-04,Utah,103873,2379,2996,0,5375,2010,Apr
2010-04,Vermont,0,830,1181,11,2022,2010,Apr
2010-04,Virgin Islands,145,15,1,0,16,2010,Apr
2010-04,Virginia,0,25259,18158,0,43417,2010,Apr
2010-04,Washington,6830,10384,7986,347,18717,2010,Apr
2010-04,West Virginia,0,3927,4534,53,8514,2010,Apr
2010-04,Wisconsin,0,5414,10701,108,16223,2010,Apr
2010-04,Wyoming,532,1295,1700,38,3033,2010,Apr
2010-03,Alabama,460,11242,10951,179,22372,2010,Mar
2010-03,Alaska,0,2297,2735,81,5113,2010,Mar
2010-03,Arizona,2988,7463,5783,180,13426,2010,Mar
2010-03,Arkansas,3458,5632,5082,60,10774,2010,Mar
2010-03,California,25069,23487,25449,0,48936,2010,Mar
2010-03,Colorado,0,12245,11297,0,23542,2010,Mar
2010-03,Connecticut,10516,4842,3959,58,8859,2010,Mar
2010-03,Delaware,0,1024,790,29,1843,2010,Mar
2010-03,District of Columbia,1,38,1,0,39,2010,Mar
2010-03,Florida,0,32241,16265,0,48506,2010,Mar
2010-03,Georgia,11603,10166,7367,144,17677,2010,Mar
2010-03,Guam,0,28,28,3,59,2010,Mar
2010-03,Hawaii,1054,0,0,0,0,2010,Mar
2010-03,Idaho,2155,2240,3694,55,5989,2010,Mar
2010-03,Illinois,42135,11425,11398,0,22823,2010,Mar
2010-03,Indiana,8505,12071,10378,386,22835,2010,Mar
2010-03,Iowa,9436,73,4220,12,4305,2010,Mar
2010-03,Kansas,0,6180,5547,155,11882,2010,Mar
2010-03,Kentucky,190528,8521,8143,126,16790,2010,Mar
2010-03,Louisiana,0,8470,7264,199,15933,2010,Mar
2010-03,Maine,0,2495,3053,43,5591,2010,Mar
2010-03,Mariana Islands,0,0,0,0,0,2010,Mar
2010-03,Maryland,0,4343,3889,22,8254,2010,Mar
2010-03,Massachusetts,4302,3401,2105,109,5615,2010,Mar
2010-03,Michigan,23107,2199,11678,161,14038,2010,Mar
2010-03,Minnesota,11784,6581,10129,156,16866,2010,Mar
2010-03,Mississippi,453,5106,5257,104,10467,2010,Mar
2010-03,Missouri,3096,15617,12253,341,28211,2010,Mar
2010-03,Montana,891,2383,4352,46,6781,2010,Mar
2010-03,Nebraska,3099,62,2201,8,2271,2010,Mar
2010-03,Nevada,1509,4820,3390,0,8210,2010,Mar
2010-03,New Hampshire,2525,2791,2354,17,5162,2010,Mar
2010-03,New Jersey,0,2707,2159,0,4866,2010,Mar
2010-03,New Mexico,464,4443,4068,115,8626,2010,Mar
2010-03,New York,2975,6093,12810,380,19283,2010,Mar
2010-03,North Carolina,16819,281,9850,213,10344,2010,Mar
2010-03,North Dakota,366,1108,2342,21,3471,2010,Mar
2010-03,Ohio,0,21508,14073,456,36037,2010,Mar
2010-03,Oklahoma,0,8887,7274,257,16418,2010,Mar
2010-03,Oregon,143,8050,9568,0,17618,2010,Mar
2010-03,Pennsylvania,201,1,65524,0,65525,2010,Mar
2010-03,Puerto Rico,0,559,117,1,677,2010,Mar
2010-03,Rhode Island,0,803,636,23,1462,2010,Mar
2010-03,South Carolina,4648,7391,4645,89,12125,2010,Mar
2010-03,South Dakota,0,1715,3283,32,5030,2010,Mar
2010-03,Tennessee,16223,15605,10938,0,26543,2010,Mar
2010-03,Texas,9945,31512,25440,765,57717,2010,Mar
2010-03,Utah,10775,2762,3486,0,6248,2010,Mar
2010-03,Vermont,0,1081,1495,14,2590,2010,Mar
2010-03,Virgin Islands,121,7,2,0,9,2010,Mar
2010-03,Virginia,0,18718,11119,0,29837,2010,Mar
2010-03,Washington,8286,11607,9443,439,21489,2010,Mar
2010-03,West Virginia,6,5216,5857,113,11186,2010,Mar
2010-03,Wisconsin,1,6911,14209,163,21283,2010,Mar
2010-03,Wyoming,563,1473,1934,34,3441,2010,Mar
2010-02,Alabama,408,13055,11229,222,24506,2010,Feb
2010-02,Alaska,0,1934,2104,78,4116,2010,Feb
2010-02,Arizona,2665,8329,6312,196,14837,2010,Feb
2010-02,Arkansas,1346,6346,6412,61,12819,2010,Feb
2010-02,California,23478,19706,21016,0,40722,2010,Feb
2010-02,Colorado,0,11557,10569,0,22126,2010,Feb
2010-02,Connecticut,7349,4327,3223,22,7572,2010,Feb
2010-02,Delaware,0,726,627,14,1367,2010,Feb
2010-02,District of Columbia,0,28,1,0,29,2010,Feb
2010-02,Florida,1,30890,16415,0,47305,2010,Feb
2010-02,Georgia,10026,12525,8331,121,20977,2010,Feb
2010-02,Guam,0,19,29,0,48,2010,Feb
2010-02,Hawaii,829,0,0,0,0,2010,Feb
2010-02,Idaho,1703,2150,3451,43,5644,2010,Feb
2010-02,Illinois,35197,9998,10190,0,20188,2010,Feb
2010-02,Indiana,7970,11285,9441,302,21028,2010,Feb
2010-02,Iowa,7164,61,3259,20,3340,2010,Feb
2010-02,Kansas,0,5920,5742,135,11797,2010,Feb
2010-02,Kentucky,185467,9886,9557,138,19581,2010,Feb
2010-02,Louisiana,0,9146,7329,207,16682,2010,Feb
2010-02,Maine,0,2053,2462,37,4552,2010,Feb
2010-02,Mariana Islands,0,0,0,0,0,2010,Feb
2010-02,Maryland,0,3322,3343,35,6700,2010,Feb
2010-02,Massachusetts,3566,2858,1628,160,4646,2010,Feb
2010-02,Michigan,18936,2017,10098,155,12270,2010,Feb
2010-02,Minnesota,7983,4957,7188,141,12286,2010,Feb
2010-02,Mississippi,310,6188,5762,84,12034,2010,Feb
2010-02,Missouri,1456,16080,12779,283,29142,2010,Feb
2010-02,Montana,725,2132,3558,41,5731,2010,Feb
2010-02,Nebraska,2578,23,1864,8,1895,2010,Feb
2010-02,Nevada,1042,4013,3119,0,7132,2010,Feb
2010-02,New Hampshire,1735,2452,2150,18,4620,2010,Feb
2010-02,New Jersey,0,1915,1675,0,3590,2010,Feb
2010-02,New Mexico,473,4232,3940,95,8267,2010,Feb
2010-02,New York,2474,4702,10776,272,15750,2010,Feb
2010-02,North Carolina,14598,325,11629,208,12162,2010,Feb
2010-02,North Dakota,183,868,1943,20,2831,2010,Feb
2010-02,Ohio,0,18528,12089,408,31025,2010,Feb
2010-02,Oklahoma,0,10593,8169,262,19024,2010,Feb
2010-02,Oregon,71,7376,8846,0,16222,2010,Feb
2010-02,Pennsylvania,135,0,47152,0,47152,2010,Feb
2010-02,Puerto Rico,0,490,121,3,614,2010,Feb
2010-02,Rhode Island,0,717,499,16,1232,2010,Feb
2010-02,South Carolina,3329,9261,5147,98,14506,2010,Feb
2010-02,South Dakota,0,1518,2978,34,4530,2010,Feb
2010-02,Tennessee,15683,18309,12832,0,31141,2010,Feb
2010-02,Texas,7572,36493,27823,939,65255,2010,Feb
2010-02,Utah,15950,2861,3624,0,6485,2010,Feb
2010-02,Vermont,0,989,1194,19,2202,2010,Feb
2010-02,Virgin Islands,94,17,1,0,18,2010,Feb
2010-02,Virginia,0,14130,11132,0,25262,2010,Feb
2010-02,Washington,6674,11162,9260,386,20808,2010,Feb
2010-02,West Virginia,4,4859,5705,95,10659,2010,Feb
2010-02,Wisconsin,0,5615,9841,147,15603,2010,Feb
2010-02,Wyoming,407,1330,1680,34,3044,2010,Feb
2010-01,Alabama,397,9404,10081,153,19638,2010,Jan
2010-01,Alaska,0,1532,1812,67,3411,2010,Jan
2010-01,Arizona,2211,6479,5178,201,11858,2010,Jan
2010-01,Arkansas,1841,3783,5039,55,8877,2010,Jan
2010-01,California,24653,18280,20059,0,38339,2010,Jan
2010-01,Colorado,0,10471,10141,0,20612,2010,Jan
2010-01,Connecticut,7855,4147,3316,20,7483,2010,Jan
2010-01,Delaware,0,785,792,12,1589,2010,Jan
2010-01,District of Columbia,0,20,1,0,21,2010,Jan
2010-01,Florida,0,27038,15924,0,42962,2010,Jan
2010-01,Georgia,9881,8603,7074,123,15800,2010,Jan
2010-01,Guam,0,26,25,1,52,2010,Jan
2010-01,Hawaii,826,0,0,0,0,2010,Jan
2010-01,Idaho,1761,1731,2693,33,4457,2010,Jan
2010-01,Illinois,39777,8799,9303,0,18102,2010,Jan
2010-01,Indiana,7459,9948,8614,294,18856,2010,Jan
2010-01,Iowa,7530,36,2748,16,2800,2010,Jan
2010-01,Kansas,0,5077,5286,144,10507,2010,Jan
2010-01,Kentucky,183423,7133,7283,107,14523,2010,Jan
2010-01,Louisiana,0,6607,7589,131,14327,2010,Jan
2010-01,Maine,0,1590,2036,34,3660,2010,Jan
2010-01,Mariana Islands,0,0,0,0,0,2010,Jan
2010-01,Maryland,0,3474,3364,20,6858,2010,Jan
2010-01,Massachusetts,3744,3060,1890,113,5063,2010,Jan
2010-01,Michigan,15231,1901,8441,129,10471,2010,Jan
2010-01,Minnesota,8686,4478,6191,161,10830,2010,Jan
2010-01,Mississippi,280,3800,5394,59,9253,2010,Jan
2010-01,Missouri,989,12126,10374,270,22770,2010,Jan
2010-01,Montana,592,1596,3017,40,4653,2010,Jan
2010-01,Nebraska,2149,12,1800,5,1817,2010,Jan
2010-01,Nevada,729,3511,2806,0,6317,2010,Jan
2010-01,New Hampshire,1878,2346,1998,11,4355,2010,Jan
2010-01,New Jersey,0,1958,2011,0,3969,2010,Jan
2010-01,New Mexico,335,2994,3356,73,6423,2010,Jan
2010-01,New York,2355,4521,10202,252,14975,2010,Jan
2010-01,North Carolina,13077,230,9770,165,10165,2010,Jan
2010-01,North Dakota,270,684,1895,17,2596,2010,Jan
2010-01,Ohio,0,16178,11272,435,27885,2010,Jan
2010-01,Oklahoma,0,7104,6793,203,14100,2010,Jan
2010-01,Oregon,26,5995,6714,0,12709,2010,Jan
2010-01,Pennsylvania,165,0,47194,0,47194,2010,Jan
2010-01,Puerto Rico,0,483,87,1,571,2010,Jan
2010-01,Rhode Island,0,648,504,21,1173,2010,Jan
2010-01,South Carolina,4510,6079,4278,93,10450,2010,Jan
2010-01,South Dakota,0,1194,2423,29,3646,2010,Jan
2010-01,Tennessee,2873,12900,9816,0,22716,2010,Jan
2010-01,Texas,7487,27645,26553,746,54944,2010,Jan
2010-01,Utah,36906,2356,2824,0,5180,2010,Jan
2010-01,Vermont,0,647,801,25,1473,2010,Jan
2010-01,Virgin Islands,62,21,2,0,23,2010,Jan
2010-01,Virginia,0,11513,10323,0,21836,2010,Jan
2010-01,Washington,6640,9348,8287,471,18106,2010,Jan
2010-01,West Virginia,26,3735,4860,61,8656,2010,Jan
2010-01,Wisconsin,0,4382,7950,153,12485,2010,Jan
2010-01,Wyoming,379,1036,1413,26,2475,2010,Jan
2009-12,Alabama,491,13285,23760,176,37221,2009,Dec
2009-12,Alaska,0,2178,3397,107,5682,2009,Dec
2009-12,Arizona,2143,7360,8454,207,16021,2009,Dec
2009-12,Arkansas,2646,5310,12090,45,17445,2009,Dec
2009-12,California,22518,19496,27200,0,46696,2009,Dec
2009-12,Colorado,0,11307,14781,0,26088,2009,Dec
2009-12,Connecticut,6791,4091,4246,21,8358,2009,Dec
2009-12,Delaware,0,871,1329,21,2221,2009,Dec
2009-12,District of Columbia,0,19,0,0,19,2009,Dec
2009-12,Florida,0,29581,24460,0,54041,2009,Dec
2009-12,Georgia,7742,10771,17354,90,28215,2009,Dec
2009-12,Guam,0,25,33,3,61,2009,Dec
2009-12,Hawaii,992,0,0,0,0,2009,Dec
2009-12,Idaho,1404,2153,5188,51,7392,2009,Dec
2009-12,Illinois,44976,9316,13652,0,22968,2009,Dec
2009-12,Indiana,6771,9904,14739,218,24861,2009,Dec
2009-12,Iowa,8021,42,5570,6,5618,2009,Dec
2009-12,Kansas,0,5473,9638,134,15245,2009,Dec
2009-12,Kentucky,179234,9768,16164,134,26066,2009,Dec
2009-12,Louisiana,0,9719,20417,132,30268,2009,Dec
2009-12,Maine,0,1949,3627,38,5614,2009,Dec
2009-12,Mariana Islands,0,0,0,0,0,2009,Dec
2009-12,Maryland,1,3095,5433,11,8539,2009,Dec
2009-12,Massachusetts,3731,2476,2014,79,4569,2009,Dec
2009-12,Michigan,15096,1867,14945,146,16958,2009,Dec
2009-12,Minnesota,5968,4912,10262,131,15305,2009,Dec
2009-12,Mississippi,239,5272,16234,94,21600,2009,Dec
2009-12,Missouri,927,14525,19444,274,34243,2009,Dec
2009-12,Montana,464,2083,5309,62,7454,2009,Dec
2009-12,Nebraska,2224,21,3960,4,3985,2009,Dec
2009-12,Nevada,1050,4493,4516,0,9009,2009,Dec
2009-12,New Hampshire,1507,2421,2572,0,4993,2009,Dec
2009-12,New Jersey,0,2139,2754,0,4893,2009,Dec
2009-12,New Mexico,419,3806,5524,90,9420,2009,Dec
2009-12,New York,3063,4652,15879,206,20737,2009,Dec
2009-12,North Carolina,12785,239,21565,208,22012,2009,Dec
2009-12,North Dakota,286,852,2860,8,3720,2009,Dec
2009-12,Ohio,0,17880,20595,320,38795,2009,Dec
2009-12,Oklahoma,0,9249,13253,176,22678,2009,Dec
2009-12,Oregon,53,6912,11402,0,18314,2009,Dec
2009-12,Pennsylvania,134,0,56138,0,56138,2009,Dec
2009-12,Puerto Rico,0,600,106,4,710,2009,Dec
2009-12,Rhode Island,0,645,636,17,1298,2009,Dec
2009-12,South Carolina,3429,7431,9987,64,17482,2009,Dec
2009-12,South Dakota,0,1367,4622,23,6012,2009,Dec
2009-12,Tennessee,10098,16886,20554,0,37440,2009,Dec
2009-12,Texas,9640,38003,55742,607,94352,2009,Dec
2009-12,Utah,8407,3123,6483,0,9606,2009,Dec
2009-12,Vermont,0,769,1249,14,2032,2009,Dec
2009-12,Virgin Islands,61,30,2,0,32,2009,Dec
2009-12,Virginia,0,11911,17572,0,29483,2009,Dec
2009-12,Washington,6058,11211,12797,370,24378,2009,Dec
2009-12,West Virginia,0,5102,9994,85,15181,2009,Dec
2009-12,Wisconsin,0,5164,11178,92,16434,2009,Dec
2009-12,Wyoming,396,1366,2548,22,3936,2009,Dec
2009-11,Alabama,399,8846,17054,113,26013,2009,Nov
2009-11,Alaska,0,1743,2575,90,4408,2009,Nov
2009-11,Arizona,1722,4950,5721,113,10784,2009,Nov
2009-11,Arkansas,1906,3487,9651,37,13175,2009,Nov
2009-11,California,17144,16571,22677,0,39248,2009,Nov
2009-11,Colorado,0,9422,11977,0,21399,2009,Nov
2009-11,Connecticut,6214,3409,3866,22,7297,2009,Nov
2009-11,Delaware,0,656,1227,16,1899,2009,Nov
2009-11,District of Columbia,0,29,0,0,29,2009,Nov
2009-11,Florida,0,25427,17590,0,43017,2009,Nov
2009-11,Georgia,6458,6802,10988,70,17860,2009,Nov
2009-11,Guam,0,21,22,0,43,2009,Nov
2009-11,Hawaii,859,0,0,0,0,2009,Nov
2009-11,Idaho,1387,1540,3649,32,5221,2009,Nov
2009-11,Illinois,43221,7925,12399,0,20324,2009,Nov
2009-11,Indiana,6427,7883,14084,191,22158,2009,Nov
2009-11,Iowa,5560,27,5416,12,5455,2009,Nov
2009-11,Kansas,0,4396,8394,99,12889,2009,Nov
2009-11,Kentucky,172706,6521,12119,120,18760,2009,Nov
2009-11,Louisiana,0,6232,13866,132,20230,2009,Nov
2009-11,Maine,0,1552,3607,31,5190,2009,Nov
2009-11,Mariana Islands,0,0,0,0,0,2009,Nov
2009-11,Maryland,0,3567,5674,12,9253,2009,Nov
2009-11,Massachusetts,3810,2420,2251,73,4744,2009,Nov
2009-11,Michigan,13601,1814,16893,99,18806,2009,Nov
2009-11,Minnesota,5053,3966,10999,95,15060,2009,Nov
2009-11,Mississippi,216,3428,11069,83,14580,2009,Nov
2009-11,Missouri,860,10663,16145,216,27024,2009,Nov
2009-11,Montana,439,1521,3913,19,5453,2009,Nov
2009-11,Nebraska,2024,16,3611,7,3634,2009,Nov
2009-11,Nevada,1060,3411,3284,0,6695,2009,Nov
2009-11,New Hampshire,1559,2234,2729,0,4963,2009,Nov
2009-11,New Jersey,0,1999,2644,0,4643,2009,Nov
2009-11,New Mexico,377,2699,3571,66,6336,2009,Nov
2009-11,New York,2257,4162,16442,242,20846,2009,Nov
2009-11,North Carolina,10753,214,15387,117,15718,2009,Nov
2009-11,North Dakota,246,737,2881,15,3633,2009,Nov
2009-11,Ohio,0,15223,20759,314,36296,2009,Nov
2009-11,Oklahoma,0,7205,10286,190,17681,2009,Nov
2009-11,Oregon,86,5618,8861,0,14479,2009,Nov
2009-11,Pennsylvania,170,0,59769,0,59769,2009,Nov
2009-11,Puerto Rico,0,471,94,4,569,2009,Nov
2009-11,Rhode Island,0,554,534,26,1114,2009,Nov
2009-11,South Carolina,4166,7783,8398,50,16231,2009,Nov
2009-11,South Dakota,0,1012,4323,15,5350,2009,Nov
2009-11,Tennessee,12729,12301,15026,0,27327,2009,Nov
2009-11,Texas,20688,27116,36125,466,63707,2009,Nov
2009-11,Utah,6087,2402,4379,0,6781,2009,Nov
2009-11,Vermont,0,529,1500,16,2045,2009,Nov
2009-11,Virgin Islands,98,15,4,0,19,2009,Nov
2009-11,Virginia,0,11099,15971,0,27070,2009,Nov
2009-11,Washington,4965,8101,9112,278,17491,2009,Nov
2009-11,West Virginia,54,3522,9722,59,13303,2009,Nov
2009-11,Wisconsin,0,4708,14139,76,18923,2009,Nov
2009-11,Wyoming,353,1023,1758,21,2802,2009,Nov
2009-10,Alabama,419,9051,13174,117,22342,2009,Oct
2009-10,Alaska,0,2400,3491,79,5970,2009,Oct
2009-10,Arizona,2595,5272,5127,133,10532,2009,Oct
2009-10,Arkansas,3358,3362,7981,23,11366,2009,Oct
2009-10,California,27218,17537,19713,0,37250,2009,Oct
2009-10,Colorado,0,8995,11262,0,20257,2009,Oct
2009-10,Connecticut,6960,3830,3937,14,7781,2009,Oct
2009-10,Delaware,0,715,1006,11,1732,2009,Oct
2009-10,District of Columbia,0,28,0,0,28,2009,Oct
2009-10,Florida,0,25740,15529,0,41269,2009,Oct
2009-10,Georgia,6852,7054,10157,88,17299,2009,Oct
2009-10,Guam,0,19,28,2,49,2009,Oct
2009-10,Hawaii,853,0,0,0,0,2009,Oct
2009-10,Idaho,1323,1559,3962,18,5539,2009,Oct
2009-10,Illinois,45473,8321,11369,0,19690,2009,Oct
2009-10,Indiana,7499,8784,11917,253,20954,2009,Oct
2009-10,Iowa,6675,33,4700,14,4747,2009,Oct
2009-10,Kansas,0,4912,7135,106,12153,2009,Oct
2009-10,Kentucky,171503,6802,11016,119,17937,2009,Oct
2009-10,Louisiana,0,6313,13425,128,19866,2009,Oct
2009-10,Maine,0,1905,5557,34,7496,2009,Oct
2009-10,Mariana Islands,0,0,0,0,0,2009,Oct
2009-10,Maryland,0,3209,4739,13,7961,2009,Oct
2009-10,Massachusetts,3759,2700,2233,110,5043,2009,Oct
2009-10,Michigan,15026,1847,14413,128,16388,2009,Oct
2009-10,Minnesota,7086,4546,16459,115,21120,2009,Oct
2009-10,Mississippi,239,3643,7635,67,11345,2009,Oct
2009-10,Missouri,1000,12308,16487,198,28993,2009,Oct
2009-10,Montana,590,1733,5721,45,7499,2009,Oct
2009-10,Nebraska,2560,13,3290,8,3311,2009,Oct
2009-10,Nevada,756,3708,3096,0,6804,2009,Oct
2009-10,New Hampshire,2549,2724,3388,0,6112,2009,Oct
2009-10,New Jersey,0,2393,2497,0,4890,2009,Oct
2009-10,New Mexico,446,3191,3570,58,6819,2009,Oct
2009-10,New York,3228,4851,17047,189,22087,2009,Oct
2009-10,North Carolina,11507,212,13089,145,13446,2009,Oct
2009-10,North Dakota,400,729,4300,13,5042,2009,Oct
2009-10,Ohio,0,15130,15489,327,30946,2009,Oct
2009-10,Oklahoma,0,6218,8201,184,14603,2009,Oct
2009-10,Oregon,40,5616,8543,0,14159,2009,Oct
2009-10,Pennsylvania,152,0,55853,0,55853,2009,Oct
2009-10,Puerto Rico,0,576,111,6,693,2009,Oct
2009-10,Rhode Island,0,654,584,27,1265,2009,Oct
2009-10,South Carolina,4422,4957,5714,48,10719,2009,Oct
2009-10,South Dakota,0,1127,5923,26,7076,2009,Oct
2009-10,Tennessee,10163,12770,12309,0,25079,2009,Oct
2009-10,Texas,8933,24638,32633,498,57769,2009,Oct
2009-10,Utah,25114,2056,3591,0,5647,2009,Oct
2009-10,Vermont,0,692,1687,13,2392,2009,Oct
2009-10,Virgin Islands,92,21,0,0,21,2009,Oct
2009-10,Virginia,0,12430,14753,0,27183,2009,Oct
2009-10,Washington,5679,8594,9790,317,18701,2009,Oct
2009-10,West Virginia,0,3582,8264,63,11909,2009,Oct
2009-10,Wisconsin,0,4807,15777,113,20697,2009,Oct
2009-10,Wyoming,460,915,1764,23,2702,2009,Oct
2009-09,Alabama,377,7789,11911,116,19816,2009,Sep
2009-09,Alaska,0,1708,2670,61,4439,2009,Sep
2009-09,Arizona,2231,5369,5353,126,10848,2009,Sep
2009-09,Arkansas,2244,3447,6513,24,9984,2009,Sep
2009-09,California,27887,15805,19228,0,35033,2009,Sep
2009-09,Colorado,0,9181,9886,0,19067,2009,Sep
2009-09,Connecticut,9076,3276,3077,12,6365,2009,Sep
2009-09,Delaware,0,678,798,8,1484,2009,Sep
2009-09,District of Columbia,0,23,0,0,23,2009,Sep
2009-09,Florida,0,23346,13521,0,36867,2009,Sep
2009-09,Georgia,7774,6389,7383,76,13848,2009,Sep
2009-09,Guam,0,20,18,3,41,2009,Sep
2009-09,Hawaii,867,0,0,0,0,2009,Sep
2009-09,Idaho,1279,1500,3685,26,5211,2009,Sep
2009-09,Illinois,43429,6722,9425,0,16147,2009,Sep
2009-09,Indiana,9155,6860,8705,170,15735,2009,Sep
2009-09,Iowa,5119,29,3416,10,3455,2009,Sep
2009-09,Kansas,0,3726,5308,80,9114,2009,Sep
2009-09,Kentucky,168779,5913,8115,86,14114,2009,Sep
2009-09,Louisiana,0,8739,14274,135,23148,2009,Sep
2009-09,Maine,0,1763,3787,33,5583,2009,Sep
2009-09,Mariana Islands,0,0,0,0,0,2009,Sep
2009-09,Maryland,0,3241,3717,9,6967,2009,Sep
2009-09,Massachusetts,3538,2181,1784,96,4061,2009,Sep
2009-09,Michigan,14252,1690,12250,123,14063,2009,Sep
2009-09,Minnesota,6866,4113,13734,95,17942,2009,Sep
2009-09,Mississippi,268,3295,6237,71,9603,2009,Sep
2009-09,Missouri,962,10959,11621,191,22771,2009,Sep
2009-09,Montana,650,1808,4398,33,6239,2009,Sep
2009-09,Nebraska,2045,8,2476,9,2493,2009,Sep
2009-09,Nevada,878,2868,2614,0,5482,2009,Sep
2009-09,New Hampshire,1670,2078,2554,0,4632,2009,Sep
2009-09,New Jersey,0,2182,1819,0,4001,2009,Sep
2009-09,New Mexico,423,2873,3316,71,6260,2009,Sep
2009-09,New York,2882,4246,13698,227,18171,2009,Sep
2009-09,North Carolina,11505,183,10168,118,10469,2009,Sep
2009-09,North Dakota,758,643,2787,9,3439,2009,Sep
2009-09,Ohio,0,12947,12103,338,25388,2009,Sep
2009-09,Oklahoma,0,5729,6593,155,12477,2009,Sep
2009-09,Oregon,62,5443,8675,0,14118,2009,Sep
2009-09,Pennsylvania,189,0,50144,0,50144,2009,Sep
2009-09,Puerto Rico,0,535,162,4,701,2009,Sep
2009-09,Rhode Island,0,444,551,26,1021,2009,Sep
2009-09,South Carolina,4187,4909,5215,62,10186,2009,Sep
2009-09,South Dakota,0,1115,4207,20,5342,2009,Sep
2009-09,Tennessee,5863,11365,9855,0,21220,2009,Sep
2009-09,Texas,9313,21498,33233,411,55142,2009,Sep
2009-09,Utah,10164,2013,3448,0,5461,2009,Sep
2009-09,Vermont,0,634,1353,15,2002,2009,Sep
2009-09,Virgin Islands,125,21,0,0,21,2009,Sep
2009-09,Virginia,0,9887,11211,0,21098,2009,Sep
2009-09,Washington,5793,7347,8666,196,16209,2009,Sep
2009-09,West Virginia,62,3374,5763,64,9201,2009,Sep
2009-09,Wisconsin,0,4682,12645,88,17415,2009,Sep
2009-09,Wyoming,442,1015,1813,17,2845,2009,Sep
2009-08,Alabama,387,8680,11371,138,20189,2009,Aug
2009-08,Alaska,0,1777,2712,56,4545,2009,Aug
2009-08,Arizona,2689,5539,5189,142,10870,2009,Aug
2009-08,Arkansas,3176,3682,4827,40,8549,2009,Aug
2009-08,California,27339,17376,21212,0,38588,2009,Aug
2009-08,Colorado,0,9391,9936,0,19327,2009,Aug
2009-08,Connecticut,8631,3486,2936,16,6438,2009,Aug
2009-08,Delaware,0,699,808,11,1518,2009,Aug
2009-08,District of Columbia,0,30,0,0,30,2009,Aug
2009-08,Florida,0,24043,13398,0,37441,2009,Aug
2009-08,Georgia,7877,7279,6932,81,14292,2009,Aug
2009-08,Guam,0,20,19,2,41,2009,Aug
2009-08,Hawaii,687,0,0,0,0,2009,Aug
2009-08,Idaho,1320,1510,3112,23,4645,2009,Aug
2009-08,Illinois,38289,6978,9265,0,16243,2009,Aug
2009-08,Indiana,1733,7900,8544,201,16645,2009,Aug
2009-08,Iowa,4451,32,2608,15,2655,2009,Aug
2009-08,Kansas,0,4333,5339,120,9792,2009,Aug
2009-08,Kentucky,165893,5978,7073,91,13142,2009,Aug
2009-08,Louisiana,0,6833,9223,114,16170,2009,Aug
2009-08,Maine,0,1544,2572,25,4141,2009,Aug
2009-08,Mariana Islands,0,0,0,0,0,2009,Aug
2009-08,Maryland,0,2939,3317,9,6265,2009,Aug
2009-08,Massachusetts,3088,1978,1426,131,3535,2009,Aug
2009-08,Michigan,14093,1905,9943,130,11978,2009,Aug
2009-08,Minnesota,5845,4483,10322,112,14917,2009,Aug
2009-08,Mississippi,252,3621,5482,61,9164,2009,Aug
2009-08,Missouri,1142,11415,11302,196,22913,2009,Aug
2009-08,Montana,690,1999,4069,32,6100,2009,Aug
2009-08,Nebraska,1895,7,2105,5,2117,2009,Aug
2009-08,Nevada,856,3342,2822,0,6164,2009,Aug
2009-08,New Hampshire,1907,1920,2184,0,4104,2009,Aug
2009-08,New Jersey,0,2368,1724,0,4092,2009,Aug
2009-08,New Mexico,642,3127,3238,68,6433,2009,Aug
2009-08,New York,3087,3989,9924,202,14115,2009,Aug
2009-08,North Carolina,11878,193,9260,149,9602,2009,Aug
2009-08,North Dakota,266,634,2335,11,2980,2009,Aug
2009-08,Ohio,0,12895,11300,367,24562,2009,Aug
2009-08,Oklahoma,0,6981,6726,160,13867,2009,Aug
2009-08,Oregon,29,5231,6588,0,11819,2009,Aug
2009-08,Pennsylvania,177,0,44637,0,44637,2009,Aug
2009-08,Puerto Rico,0,504,162,9,675,2009,Aug
2009-08,Rhode Island,0,480,402,15,897,2009,Aug
2009-08,South Carolina,4445,5034,4635,56,9725,2009,Aug
2009-08,South Dakota,0,1054,3326,26,4406,2009,Aug
2009-08,Tennessee,34101,11855,9296,0,21151,2009,Aug
2009-08,Texas,15638,24624,30487,523,55634,2009,Aug
2009-08,Utah,15296,1856,2941,0,4797,2009,Aug
2009-08,Vermont,0,671,927,9,1607,2009,Aug
2009-08,Virgin Islands,117,15,3,0,18,2009,Aug
2009-08,Virginia,0,10372,10198,0,20570,2009,Aug
2009-08,Washington,5184,7816,8045,207,16068,2009,Aug
2009-08,West Virginia,4,3509,4396,63,7968,2009,Aug
2009-08,Wisconsin,0,4500,9966,93,14559,2009,Aug
2009-08,Wyoming,523,1106,1746,12,2864,2009,Aug
2009-07,Alabama,395,8101,8815,149,17065,2009,Jul
2009-07,Alaska,0,1710,2072,69,3851,2009,Jul
2009-07,Arizona,4687,5554,4386,155,10095,2009,Jul
2009-07,Arkansas,4196,3540,3779,52,7371,2009,Jul
2009-07,California,25623,18555,17211,0,35766,2009,Jul
2009-07,Colorado,0,8577,8285,0,16862,2009,Jul
2009-07,Connecticut,9495,3273,2502,23,5798,2009,Jul
2009-07,Delaware,0,671,534,9,1214,2009,Jul
2009-07,District of Columbia,0,24,0,0,24,2009,Jul
2009-07,Florida,0,23694,12349,0,36043,2009,Jul
2009-07,Georgia,9308,6383,4781,82,11246,2009,Jul
2009-07,Guam,0,10,21,2,33,2009,Jul
2009-07,Hawaii,813,0,0,0,0,2009,Jul
2009-07,Idaho,1518,1426,2361,30,3817,2009,Jul
2009-07,Illinois,33386,6742,6733,0,13475,2009,Jul
2009-07,Indiana,1,6953,6249,203,13405,2009,Jul
2009-07,Iowa,4411,29,1747,13,1789,2009,Jul
2009-07,Kansas,0,3648,3510,101,7259,2009,Jul
2009-07,Kentucky,163417,6320,5795,147,12262,2009,Jul
2009-07,Louisiana,0,6784,6226,169,13179,2009,Jul
2009-07,Maine,0,1405,2145,34,3584,2009,Jul
2009-07,Mariana Islands,0,0,0,0,0,2009,Jul
2009-07,Maryland,0,3445,2749,10,6204,2009,Jul
2009-07,Massachusetts,2954,2181,1422,101,3704,2009,Jul
2009-07,Michigan,13872,1846,7062,125,9033,2009,Jul
2009-07,Minnesota,6693,3775,6199,109,10083,2009,Jul
2009-07,Mississippi,284,3519,3617,59,7195,2009,Jul
2009-07,Missouri,961,10460,8303,168,18931,2009,Jul
2009-07,Montana,684,1846,3103,35,4984,2009,Jul
2009-07,Nebraska,1601,11,1399,6,1416,2009,Jul
2009-07,Nevada,1071,3038,2282,0,5320,2009,Jul
2009-07,New Hampshire,1371,1958,1891,0,3849,2009,Jul
2009-07,New Jersey,0,2587,1748,0,4335,2009,Jul
2009-07,New Mexico,600,2801,2737,61,5599,2009,Jul
2009-07,New York,3156,4082,8313,184,12579,2009,Jul
2009-07,North Carolina,12130,176,7255,126,7557,2009,Jul
2009-07,North Dakota,389,659,1702,11,2372,2009,Jul
2009-07,Ohio,0,12794,10179,368,23341,2009,Jul
2009-07,Oklahoma,0,6465,5066,141,11672,2009,Jul
2009-07,Oregon,32,5009,5631,0,10640,2009,Jul
2009-07,Pennsylvania,207,0,42530,0,42530,2009,Jul
2009-07,Puerto Rico,0,540,97,5,642,2009,Jul
2009-07,Rhode Island,0,447,399,20,866,2009,Jul
2009-07,South Carolina,4588,5605,3270,65,8940,2009,Jul
2009-07,South Dakota,0,1038,2241,22,3301,2009,Jul
2009-07,Tennessee,6717,11526,7335,0,18861,2009,Jul
2009-07,Texas,13083,23326,20778,584,44688,2009,Jul
2009-07,Utah,27412,1712,2289,0,4001,2009,Jul
2009-07,Vermont,0,623,780,13,1416,2009,Jul
2009-07,Virgin Islands,101,16,3,0,19,2009,Jul
2009-07,Virginia,0,11029,9065,0,20094,2009,Jul
2009-07,Washington,5390,7218,6415,227,13860,2009,Jul
2009-07,West Virginia,1,3262,3751,56,7069,2009,Jul
2009-07,Wisconsin,0,4128,6078,74,10280,2009,Jul
2009-07,Wyoming,621,992,1355,16,2363,2009,Jul
2009-06,Alabama,151,7909,7335,10,15254,2009,Jun
2009-06,Alaska,0,1773,2140,4,3917,2009,Jun
2009-06,Arizona,6687,5878,4908,15,10801,2009,Jun
2009-06,Arkansas,5298,3636,3427,3,7066,2009,Jun
2009-06,California,24176,20060,18949,0,39009,2009,Jun
2009-06,Colorado,0,8963,8582,0,17545,2009,Jun
2009-06,Connecticut,10548,3588,2709,4,6301,2009,Jun
2009-06,Delaware,0,668,599,0,1267,2009,Jun
2009-06,District of Columbia,0,27,1,0,28,2009,Jun
2009-06,Florida,0,23275,12448,0,35723,2009,Jun
2009-06,Georgia,11430,6330,4656,2,10988,2009,Jun
2009-06,Guam,0,22,22,0,44,2009,Jun
2009-06,Hawaii,758,0,0,0,0,2009,Jun
2009-06,Idaho,1867,1508,2626,4,4138,2009,Jun
2009-06,Illinois,37686,6907,7155,0,14062,2009,Jun
2009-06,Indiana,7,6842,6285,15,13142,2009,Jun
2009-06,Iowa,4741,38,1771,1,1810,2009,Jun
2009-06,Kansas,0,3713,3404,4,7121,2009,Jun
2009-06,Kentucky,161497,5800,5457,10,11267,2009,Jun
2009-06,Louisiana,0,6370,5462,7,11839,2009,Jun
2009-06,Maine,0,1443,2052,2,3497,2009,Jun
2009-06,Mariana Islands,0,0,0,0,0,2009,Jun
2009-06,Maryland,0,3552,2772,0,6324,2009,Jun
2009-06,Massachusetts,3562,2256,1502,7,3765,2009,Jun
2009-06,Michigan,14856,1865,7054,13,8932,2009,Jun
2009-06,Minnesota,7232,4287,6008,5,10300,2009,Jun
2009-06,Mississippi,244,3116,3043,10,6169,2009,Jun
2009-06,Missouri,1181,10835,7823,9,18667,2009,Jun
2009-06,Montana,682,1873,3699,3,5575,2009,Jun
2009-06,Nebraska,1955,6,1354,0,1360,2009,Jun
2009-06,Nevada,1073,3372,2687,0,6059,2009,Jun
2009-06,New Hampshire,1078,1897,1902,0,3799,2009,Jun
2009-06,New Jersey,0,2815,1827,0,4642,2009,Jun
2009-06,New Mexico,691,3028,3015,4,6047,2009,Jun
2009-06,New York,2723,4358,8854,15,13227,2009,Jun
2009-06,North Carolina,13322,179,7067,9,7255,2009,Jun
2009-06,North Dakota,728,697,1700,1,2398,2009,Jun
2009-06,Ohio,0,12529,10182,14,22725,2009,Jun
2009-06,Oklahoma,0,6100,4876,5,10981,2009,Jun
2009-06,Oregon,27,5518,6207,0,11725,2009,Jun
2009-06,Pennsylvania,167,1,43184,0,43185,2009,Jun
2009-06,Puerto Rico,0,507,130,0,637,2009,Jun
2009-06,Rhode Island,0,533,443,1,977,2009,Jun
2009-06,South Carolina,5060,4802,2857,3,7662,2009,Jun
2009-06,South Dakota,0,1064,2369,0,3433,2009,Jun
2009-06,Tennessee,5112,10816,7062,0,17878,2009,Jun
2009-06,Texas,16043,23978,21010,39,45027,2009,Jun
2009-06,Utah,13928,2271,2773,0,5044,2009,Jun
2009-06,Vermont,0,619,683,1,1303,2009,Jun
2009-06,Virgin Islands,154,14,1,0,15,2009,Jun
2009-06,Virginia,0,9000,7836,0,16836,2009,Jun
2009-06,Washington,6437,7632,7044,17,14693,2009,Jun
2009-06,West Virginia,0,3231,3760,5,6996,2009,Jun
2009-06,Wisconsin,0,4239,6027,5,10271,2009,Jun
2009-06,Wyoming,778,1170,1739,2,2911,2009,Jun
